ANACOLUTOS	 1. m. Gram. Inconsecuencia en la construcción del discurso.
Abra	1. f. Bahía no muy extensa. 2. f. Abertura ancha y despejada entre dos montañas. 3. f. Grieta producida en el terreno por efecto de sacudidas sísmicas.
Abula	Versión electrónica 23.4 del «Diccionario de la lengua española», obra lexicográfica académica por excelencia.
Adanismo	1. m. Hábito de comenzar una actividad cualquiera como si nadie la hubiera ejercitado anteriormente. 2. m. Desnudismo, práctica de la desnudez.
Agape	Versión electrónica 23.4 del «Diccionario de la lengua española», obra lexicográfica académica por excelencia.
Alastrar	 Tenderse contra la tierra para no ser descubierto.
Alcorán	 1. m. Corán.
Amoragar	 1. tr. p. us. Asar con fuego de leña, y en la playa, sardinas y otros peces o moluscos.
Analepsis	 1. f. Ret. Pasaje de una obra literaria que trae una escena del pasado rompiendo la secuencia cronológica.
Andalus	Versión electrónica 23.4 del «Diccionario de la lengua española», obra lexicográfica académica por excelencia.
Aovillarse	 1. prnl. Encogerse mucho, hacerse un ovillo.
Apostasía	 1. f. Acción y efecto de apostatar.
Apurruñar	 1. tr. Cuba y Ven. Apretar cariñosamente a alguien. U. t. c. prnl. 2. tr. coloq. Ven. Apretar, estrechar algo con el puño.
Arrobar	Entradas que contienen la forma «Arrobar» | Diccionario de la lengua española | RAE - ASALE
Artralgia	 1. f. Med. Dolor de las articulaciones.
Ayo	 1. m. y f. Persona encargada en las casas principales de custodiar niños o jóvenes y de cuidar de su crianza y educación.
Baldragas	 1. m. coloq. Hombre insustancial, simple y de poco carácter. U. t. c. adj.
Bebistrajo	 1. m. coloq. Mezcla irregular y extravagante de bebidas. 2. m. coloq. Bebida nauseabunda o muy desagradable.
Bedel	 1. m. y f. En los centros de enseñanza, persona cuyo oficio es cuidar del orden fuera de las aulas, además de otras funciones auxiliares.
Berzotas	 1. m. y f. coloq. Persona ignorante o necia.
Bisbisear	 1. tr. coloq. musitar.
Bogavante	Entradas que contienen la forma «Bogavante» | Diccionario de la lengua española | RAE - ASALE
Borono	Versión electrónica 23.4 del «Diccionario de la lengua española», obra lexicográfica académica por excelencia.
Bulo	 1. m. Noticia falsa propalada con algún fin.
Calabobos	 1. m. coloq. Llovizna pertinaz.
Calobiótica	 1. f. Arte de vivir bien. 2. f. Tendencia del ser humano a una vida ordenada y regular.
Camasquince	Versión electrónica 23.4 del «Diccionario de la lengua española», obra lexicográfica académica por excelencia.
Canticio	 1. m. coloq. Canto frecuente y molesto.
Catacaldos	 1. m. y f. Persona entremetida. 2. m. y f. coloq. Persona que emprende muchas cosas sin fijarse en ninguna.
Cañígitano	Versión electrónica 23.4 del «Diccionario de la lengua española», obra lexicográfica académica por excelencia.
Cernícalo	1. m. Ave de rapiña, común en España, de unos 40 cm de largo, con cabeza abultada, pico y uñas negros y fuertes, y plumaje rojizo más oscuro por la espalda que por el pecho y manchado de negro.
Chafalmejas	 1. m. y f. coloq. pintamonas.
Chapuza	1. f. Obra o trabajo, generalmente de mantenimiento, de poca importancia. 2. f. Trabajo hecho mal y sin esmero. 3. f. Méx. estafa (‖ acción de estafar).
Chicote	Entradas que contienen la forma «Chicote» | Diccionario de la lengua española | RAE - ASALE
Chuminada	 1. f. coloq. Tontería, estupidez, cosa sin importancia.
Chupatintas	 1. m. y f. despect. coloq. Oficinista de poca categoría.
Cicerone	 1. m. y f. Persona que enseña y explica las curiosidades de una localidad, edificio, etc.
Cipote	Entradas que contienen la forma «Cipote» | Diccionario de la lengua española | RAE - ASALE
Cocodriz	Versión electrónica 23.4 del «Diccionario de la lengua española», obra lexicográfica académica por excelencia.
Creso	 1. m. Hombre que posee grandes riquezas.
Crotal	1. m. Placa para la identificación y control de animales formada por dos piezas que se acoplan y se colocan en algún lugar visible de su cuerpo.
Cálamo	1. m. Especie de flauta antigua. 2. m. Parte inferior hueca del eje de las plumas de las aves, que no lleva barbas y se inserta en la piel.
Desamorrar	1. tr. coloq. Hacer que alguien levante la cabeza o que, dejando el silencio en que estaba, responda y converse con quienes están presentes.
Descomer	 1. intr. coloq. exonerar el vientre.
Desconversable	 1. adj. De genio áspero y desabrido, que huye de la conversación y trato de las gentes, o que ama el retiro y la soledad.
Deshonrabuenos	1. m. y f. coloq. desus. Persona que murmura de otros, desacreditándolos y poniéndolos en mala opinión sin razón ni verdad. 2. m. y f. coloq. desus. Persona que degenera con respecto a sus mayores.
Deslabonarse	1. tr. Soltar y desunir un eslabón de otro. U. t. c. prnl. 2. tr. Desunir y deshacer algo. U. t. c. prnl. 3. prnl. Apartarse de la compañía o trato de alguien.
Discente	 Que recibe enseñanza. 2. m. y f. estudiante (‖ persona que cursa estudios).
Disoluto	 1. adj. Licencioso, entregado a los vicios. U. t. c. s.
Dorondón	 1. m. Ar. Niebla espesa y fría.
EPÉNTESIS	 1. f. Fon. Adición de algún sonido en una palabra, especialmente en posición interior, como en tendré, del antiguo tenré.
El	1. art. deter. m. y f. Antepuesto a un sustantivo o a un sintagma nominal forma una expresión definida de referente consabido. Espérenme en el restaurante. La familia se llevaba bastante bien.
Encalabrinarse	 Causar turbación en una persona o en su cabeza. U. t. c. prnl. 2. tr. Hacer concebir a alguien falsas esperanzas.
Enhiesta	 1. adj. Levantado, derecho.
Esciente	 1. adj. desus. Que sabe.
Escrucar	 1. tr. Bad. Revolver la comida en el plato.
Espabilar	1. tr. Quitar la pavesa o la parte ya quemada del pabilo o mecha a velas y candiles. 2. tr. Avivar y ejercitar el entendimiento o el ingenio de alguien, hacerle perder la timidez o la torpeza. U. t. c. intr. y c. prnl.
Espeluznos	 1. m. coloq. Escalofrío, estremecimiento.
Espigueo	1. m. En la siega, acción de espigar. 2. m. En la siega, tiempo o sazón de espigar. 3. m. Acción y efecto de rebuscar en libros datos para algún trabajo.
Esputar	 1. tr. Arrancar flemas y arrojarlas por la boca. U. t. c. intr.
Esterarse	 1. tr. Cubrir los suelos con esteras. 2. prnl. fest. coloq. Vestirse de invierno antes de tiempo.
Eubolia	 1. f. Virtud que ayuda a hablar convenientemente, y es una de las que pertenecen a la prudencia.
Extruir	 1. tr. Tecnol. extrudir.
FARALLÓN	1. m. Roca alta y tajada que sobresale en el mar y alguna vez en tierra firme. 2. m. crestón (‖ parte de un filón que sobresale del terreno).
Foiso	 1. adj. desus. hondo.
Fruición	 1. f. Goce muy vivo en el bien que alguien posee. 2. f. Complacencia, goce. El malvado tiene fruición en ver llorar.
Fuliginoso	 1. adj. Denegrido, oscurecido, tiznado.
Fullero	 1. adj. Que hace fullerías. U. t. c. s.
Galbana	Entradas que contienen la forma «Galbana» | Diccionario de la lengua española | RAE - ASALE
Gambito	1. m. En el juego de ajedrez, lance que consiste en sacrificar, al principio de la partida, algún peón u otra pieza, o ambos, para lograr una posición favorable.
Gandul	Entradas que contienen la forma «Gandul» | Diccionario de la lengua española | RAE - ASALE
Garitero	1. m. y f. Persona que tiene por su cuenta un garito. 2. m. y f. Jugador que habitualmente acude a los garitos. 3. m. germ. Encubridor de ladrones.
Herma	 1. m. Busto sin brazos colocado sobre un estípite.
Herrete	 1. m. Remate, generalmente metálico, que se pone a las agujetas, cordones, cintas, etc., para que puedan entrar fácilmente por los ojetes.
Heñir	1. tr. Sobar con los puños la masa, especialmente la del pan. hay mucho que heñir 1. loc. verb. coloq. U. para expresar que para concluir algo todavía se necesita trabajar mucho en ello.
Ignífugo	 1. adj. Que no se inflama ni propaga la llama o el fuego. Pintura ignífuga.
Inaprensible	 1. adj. Que no se puede asir. 2. adj. Imposible de comprender.
Intonso	 Que se encuaderna sin cortar los pliegos de que se compone.
Izakaya	Versión electrónica 23.4 del «Diccionario de la lengua española», obra lexicográfica académica por excelencia.
JONUCO	 1. m. Méx. Espacio que hay debajo de la escalera de una casa.
Kakistocracia	Versión electrónica 23.4 del «Diccionario de la lengua española», obra lexicográfica académica por excelencia.
Luquete	Entradas que contienen la forma «Luquete» | Diccionario de la lengua española | RAE - ASALE
Mascullar	1. tr. coloq. Mascar mal o con dificultad. 2. tr. coloq. Hablar entre dientes, o pronunciar mal las palabras, hasta el punto de que con dificultad puedan entenderse.
Mascullé	1. tr. coloq. Mascar mal o con dificultad. 2. tr. coloq. Hablar entre dientes, o pronunciar mal las palabras, hasta el punto de que con dificultad puedan entenderse.
Meapilas	 1. m. santurrón.
Mialgia	 1. f. Med. miodinia.
Misoneísta	 1. adj. Hostil a las novedades. Apl. a pers., u. t. c. s.
Monacato	 1. m. Estado o profesión de monje. 2. m. Institución monástica.
Monipodio	 1. m. Convenio de personas que se asocian y confabulan para fines ilícitos.
Monote	 1. m. Riña o alboroto, motín. 2. m. coloq. Persona que parece no oír, ver ni entender.
Mostrenco	 Que no tiene casa ni hogar, ni señor o amo conocido. U. t. c. s. 2. adj. coloq. Ignorante o tardo en discurrir o aprender. U. t. c. s.
Nacionalcatolicismo	 1. m. Durante el régimen franquista, situación caracterizada por la estrecha relación entre el Estado y la Iglesia católica.
Nefando	 Que causa repugnancia u horror hablar de ella. pecado nefando
Nenúfar	1. m. Planta acuática de la familia de las ninfeáceas, con rizoma largo, nudoso y feculento, hojas enteras, casi redondas, de pecíolo central y tan largo que, saliendo del rizoma, llega a la superficie del agua, donde flota la hoja; flores blancas, terminales y solitarias, y fruto globoso, capsular, con muchas semillas pequeñas, elipsoidales y negruzcas.
Ocarina	1. f. Instrumento musical de forma ovoide más o menos alargada y de varios tamaños, con ocho agujeros que modifican el sonido según se tapan con los dedos. Es de timbre muy dulce.
Osasuna	Versión electrónica 23.4 del «Diccionario de la lengua española», obra lexicográfica académica por excelencia.
Otacustas	 1. m. desus. Espía o escucha. 2. m. desus. Persona que vive de traer y llevar cuentos, chismes y enredos.
PORNOCRACIA	Versión electrónica 23.4 del «Diccionario de la lengua española», obra lexicográfica académica por excelencia.
Papo	Entradas que contienen la forma «Papo» | Diccionario de la lengua española | RAE - ASALE
Pasifae	Versión electrónica 23.4 del «Diccionario de la lengua española», obra lexicográfica académica por excelencia.
Pasil	1. m. Piedra puesta para pasar un río o arroyo. 2. m. Parte por donde se puede atravesar a pie un río o un arroyo. 3. m. Paso estrecho, vereda.
Pelgar	 1. m. coloq. Hombre sin habilidad ni ocupación.
Petimetre	 1. m. y f. Persona que se preocupa mucho de su compostura y de seguir las modas.
Pielago	Versión electrónica 23.4 del «Diccionario de la lengua española», obra lexicográfica académica por excelencia.
Pilastra	 1. f. Columna de sección cuadrangular.
Plenilunio	 1. m. Astron. luna llena.
Podrigorio	 1. m. coloq. Persona llena de achaques y dolencias.
Pomporruta	Versión electrónica 23.4 del «Diccionario de la lengua española», obra lexicográfica académica por excelencia.
Poneca	 1. f. coloq. Hond. Torta seca de excremento animal o humano.
Propiocepción	 1. f. Psicol. Percepción inconsciente de los movimientos y de la posición del cuerpo, independiente de la visión.
Puiquinini	Versión electrónica 23.4 del «Diccionario de la lengua española», obra lexicográfica académica por excelencia.
Putiferio	1. m. coloq. puterío (‖ prostitución). 2. m. coloq. puterío (‖ conjunto de personas que ejercen la prostitución). 3. m. coloq. puterío (‖ situación de desmadre).
Quistarse	 1. prnl. Hacerse querer. 2. prnl. Llevarse bien con los demás.
Ramón	1. m. Ramojo que cortan los pastores para apacentar los ganados en tiempo de muchas nieves o de rigurosa sequía. 2. m. Ramaje que resulta de la poda de los olivos y otros árboles.
Rascatripas	 1. m. y f. coloq. Persona que con poca habilidad toca el violín u otro instrumento de arco.
Retinto	 De color castaño muy oscuro.
Ringlera	 1. f. Fila o línea de cosas puestas en orden unas tras otras.
Sansirolé	 1. m. y f. coloq. sancirole.
Satanelo	Versión electrónica 23.4 del «Diccionario de la lengua española», obra lexicográfica académica por excelencia.
Serifa	Versión electrónica 23.4 del «Diccionario de la lengua española», obra lexicográfica académica por excelencia.
Sinestesia	1. f. Biol. Sensación secundaria o asociada que se produce en una parte del cuerpo a consecuencia de un estímulo aplicado en otra parte de él.
Sirgamaromacuerda	Versión electrónica 23.4 del «Diccionario de la lengua española», obra lexicográfica académica por excelencia.
Soliviantando	1. tr. Mover el ánimo de alguien para inducirle a adoptar alguna actitud rebelde u hostil. U. t. c. prnl. 2. tr. Inquietar o alterar a alguien.
Suzeranía	Versión electrónica 23.4 del «Diccionario de la lengua española», obra lexicográfica académica por excelencia.
Tebeo	Entradas que contienen la forma «Tebeo» | Diccionario de la lengua española | RAE - ASALE
Tebeos	Entradas que contienen la forma «Tebeos» | Diccionario de la lengua española | RAE - ASALE
Tiberio	 1. m. coloq. Ruido, confusión, alboroto.
Tomón	 1. adj. coloq. Que toma con frecuencia, facilidad o descaro.
Tragaavemarías	 1. m. y f. coloq. desus. Persona devota que reza muchas oraciones.
Tragavirotes	 1. m. coloq. Hombre serio y erguido en demasía.
Trincapiñones	 1. m. coloq. p. us. Mozo de poco juicio.
Tullidura	 1. f. Cineg. Excremento de las aves de rapiña. U. m. en pl.
Tunante	 1. adj. Pícaro, bribón, taimado. U. t. c. s. 2. adj. desus. Que tuna. Era u. t. c. s.
Turullo	 1. m. Cuerno que usan los pastores para llamar y reunir el ganado.
VAGIDOS	 1. m. Gemido o llanto del recién nacido.
Vespasiano	Versión electrónica 23.4 del «Diccionario de la lengua española», obra lexicográfica académica por excelencia.
Virago	 1. f. Mujer varonil. U. t. c. m.
Zabuquear	 1. tr. Menear o revolver una cosa líquida moviendo la vasija en que está. 2. tr. traquetear (‖ mover o agitar líquidos y otras cosas).
Zagalo	Versión electrónica 23.4 del «Diccionario de la lengua española», obra lexicográfica académica por excelencia.
Zaino	Entradas que contienen la forma «Zaino» | Diccionario de la lengua española | RAE - ASALE
Zampabollos	 1. m. y f. coloq. Persona que come con exceso y con ansia.
abate	1. m. Presbítero extranjero, especialmente francés o italiano, y también eclesiástico español que ha residido mucho tiempo en Francia o Italia.
abstrusa	 1. adj. De difícil comprensión.
abulia	 1. f. Pasividad, desinterés, falta de voluntad.
abúlico	 1. adj. Que padece abulia. 2. adj. Propio de la abulia.
acadias	1. adj. Natural de Acad, antiguo reino de Mesopotamia. U. t. c. s. 2. adj. Perteneciente o relativo a Acad o a los acadios. 3. adj. Perteneciente o relativo al acadio (‖ lengua). Léxico acadio.
aceifa	 1. f. Incursión militar que los sarracenos solían hacer en verano en los territorios cristianos.
acrimonia	 1. f. acritud (‖ aspereza). 2. f. desus. Agudeza del dolor.
adustos	1. adj. Quemado, tostado, ardiente. 2. adj. Poco tratable, huraño, malhumorado. 3. adj. Seco, severo, desabrido. Paisaje adusto. Prosa adusta.
agrimensura	 1. f. Arte de medir tierras.
ahíto	1. adj. Que padece alguna indigestión o empacho. 2. adj. Saciado, harto. U. t. en sent. fig. 3. adj. Cansado o fastidiado de alguien o algo.
ajamonadas	Entradas que contienen la forma «ajamonadas» | Diccionario de la lengua española | RAE - ASALE
alfanje	 1. m. Especie de sable, corto y corvo, con filo solamente por un lado, y por los dos en la punta. 2. m. pez espada.
alfeñique	1. m. Pasta de azúcar cocida y estirada en barras muy delgadas y retorcidas. 2. m. coloq. Persona delicada de cuerpo y complexión. 3. m. And. valeriana.
alforfón	1. m. Planta anual de la familia de las poligonáceas, como de un metro de altura, con tallos nudosos, hojas grandes y acorazonadas, flores blancas sonrosadas, en racimo, y fruto negruzco y triangular, del que se hace pan en algunas comarcas de España.
alicrejo	1. m. C. Rica, El Salv. y Pan. Persona débil, flaca y floja. 2. m. El Salv. y Hond. Término impreciso que se aplica a cualquier animal raro o cuyo nombre se desconoce.
alimento	1. m. Conjunto de sustancias que los seres vivos comen o beben para subsistir. 2. m. Cada una de las sustancias que un ser vivo toma o recibe para su nutrición.
aloque	 Semejante al del aloque. U. t. c. s. m.
alóctono	 1. adj. Que no es originario del lugar en que se encuentra.
alóctonooriginario	Versión electrónica 23.4 del «Diccionario de la lengua española», obra lexicográfica académica por excelencia.
amanuenses	1. m. y f. Persona que tiene por oficio escribir a mano, copiando o poniendo en limpio escritos ajenos, o escribiendo lo que se le dicta. 2. m. y f. Escribiente de un despacho, oficina o tribunal.
amblar	 Andar moviendo a un tiempo el pie y la mano de un mismo lado. 2. intr. desus. Mover lúbricamente el cuerpo.
amoricones	 1. m. pl. p. us. Señas, ademanes u otras acciones con que se manifiesta el amor que se tiene a alguien. 2. m. pl. desus. Amores o amoríos.
anfibologías	1. f. Doble sentido, vicio de la palabra, cláusula o manera de hablar a que puede darse más de una interpretación. 2. f. Ret. Empleo voluntario de voces o cláusulas con doble sentido.
apostilla	 1. f. Acotación que comenta, interpreta o completa un texto.
apostura	1. f. Gentileza, buena disposición en la persona. 2. f. Actitud, ademán, aspecto. 3. f. desus. Buen orden y compostura de las cosas. 4. f. desus. Adorno, afeite, atavío.
aprisco	 1. m. Paraje donde los pastores recogen el ganado para resguardarlo de la intemperie.
arcidriche	 1. m. desus. Tablero de ajedrez.
areitos	 1. m. Canto y baile de los indios que poblaban las Grandes Antillas.
arredramos	1. tr. Apartar, separar. U. t. c. prnl. 2. tr. Retraer, hacer volver atrás, por el peligro que ofrece o el temor que infunde la ejecución de algo. U. t. c. prnl.
arrequín	 1. m. Chile, Cuba y Méx. Persona que no se separa de otra para ayudarla o acompañarla. 2. m. Cuba. Animal que guía la recua.
aruñar	 1. tr. arañar.
asteísmo	 1. m. Ret. Alabanza que se dirige con gracia y delicadeza bajo apariencia de reprensión o vituperio.
ateridos	 1. tr. Pasmar de frío. U. m. c. prnl.
attaccabottoni	Versión electrónica 23.4 del «Diccionario de la lengua española», obra lexicográfica académica por excelencia.
aurícula	1. f. Anat. Cavidad del corazón que recibe sangre de los vasos sanguíneos, cuyo número varía en los distintos grupos de animales. 2. f. Bot. Prolongación de la parte inferior del limbo de las hojas.
aventurera	 De oscuros o malos antecedentes, sin oficio ni profesión, y que por medios desconocidos o reprobados trata de conquistar en la sociedad un puesto que no le corresponde. U. m. c. s.
avituallado	 1. tr. Proveer de vituallas.
avulsión	 1. f. Med. extirpación.
aya	 1. m. y f. Persona encargada en las casas principales de custodiar niños o jóvenes y de cuidar de su crianza y educación.
ayo	 1. m. y f. Persona encargada en las casas principales de custodiar niños o jóvenes y de cuidar de su crianza y educación.
ayuntándose	Versión electrónica 23.4 del «Diccionario de la lengua española», obra lexicográfica académica por excelencia.
babá	Versión electrónica 23.4 del «Diccionario de la lengua española», obra lexicográfica académica por excelencia.
bagatelas	 1. f. Cosa de poca importancia o valor.
bajini	 por lo bajini 1. loc. adv. coloq. En voz baja. 2. loc. adv. coloq. Con disimulo.
balumba	 1. f. Bulto que hacen muchas cosas juntas. 2. f. Conjunto desordenado y excesivo de cosas.
beborrotear	 1. intr. coloq. Beber a menudo y en poca cantidad.
beocios	1. adj. Natural de Beocia, región de la Grecia antigua. U. t. c. s. 2. adj. Perteneciente o relativo a Beocia o a los beocios. 3. adj. Ignorante, estúpido, tonto.
beodo	 1. adj. Embriagado o borracho. U. t. c. s.
bichicori	Versión electrónica 23.4 del «Diccionario de la lengua española», obra lexicográfica académica por excelencia.
bienquistarme	 1. tr. Conciliar a dos o más personas entre sí. U. t. c. prnl.
bifronte	 1. adj. De dos frentes o dos caras.
birrión	 1. m. Cuba. Borrón o mancha que se produce en la cara al maquillarse mal.
bizarría	 1. f. Gallardía, valor. 2. f. Generosidad, lucimiento, esplendor. 3. f. Pint. Colorido o adorno exagerado.
botijo	1. m. Vasija de barro poroso que se usa para refrescar el agua, de vientre abultado, con asa en la parte superior, a uno de los lados boca para llenarlo de agua, y al opuesto un pitorro para beber.
breva	1. f. Primer fruto que anualmente da la higuera breval, y que es mayor que el higo. 2. f. Bellota temprana. 3. f. Cigarro puro algo aplastado y menos apretado que los de forma cilíndrica.
bridas	1. f. Freno del caballo con las riendas y todo el correaje que sirve para sujetarlo a la cabeza del animal. 2. f. Equit. Arte o modo de andar a caballo, cuyo ornato era distinto del que hoy se usa.
bruxismo	 1. m. Med. Rechinamiento de dientes involuntario que se produce especialmente durante el sueño.
buitrera	 V. buitrero.
burdéganos	 1. m. Hijo de caballo y burra, casi siempre estéril, como los mulos, y con la cabeza más grande y el cuerpo más pequeño que estos.
cabañuelas	1. f. pl. Cálculo popular basado en la observación de los cambios atmosféricos en los 12, 18 o 24 primeros días de enero o de agosto, para pronosticar el tiempo durante cada uno de los meses del mismo año o del siguiente.
cacimba	1. f. Hoyo que se hace en la playa o en el lecho de un río para buscar agua. 2. f. Oquedad natural de las rocas en que se deposita el agua de lluvia.
cadalso	1. m. Tablado construido para la ejecución de la pena de muerte. 2. m. Tablado que se levantaba para un acto solemne. 3. m. Antiguamente, fortificación o baluarte de madera.
cagaprisas	 1. m. y f. malson. coloq. Persona impaciente, que siempre tiene prisa.
camastrón	1. m. y f. coloq. Persona disimulada y doble que espera oportunidad para hacer o dejar de hacer las cosas, según le conviene. U. t. c. adj.
canguelo	 1. m. coloq. Miedo, temor.
cantamañanas	 1. m. y f. coloq. Persona informal, fantasiosa, irresponsable, que no merece crédito.
cantábrica	1. adj. Perteneciente o relativo al mar Cantábrico o a la tierra adyacente a ese mar. 2. adj. Perteneciente o relativo a la comunidad autónoma de Cantabria, en España.
capitostes	 1. m. despect. Persona con influencia, mando, etc.
caquexia	1. f. Bot. Decoloración de las partes verdes de las plantas por falta de luz. 2. f. Med. Estado de extrema desnutrición producido por enfermedades consuntivas, como la tuberculosis, las supuraciones, el cáncer, etc.
cara	1. f. Parte anterior de la cabeza humana desde el principio de la frente hasta la punta de la barbilla. 2. f. Parte anterior de la cabeza de algunos animales.
carcamales	 1. m. despect. coloq. Persona decrépita y achacosa. U. t. c. adj.
carcunda	 1. adj. despect. carlista. Apl. a pers., u. t. c. s. 2. adj. despect. De actitudes retrógradas. Apl. a pers., u. t. c. s.
carcundia	Versión electrónica 23.4 del «Diccionario de la lengua española», obra lexicográfica académica por excelencia.
carpetovetónico	1. adj. Perteneciente o relativo a los carpetanos y vetones. 2. adj. Considerado como característico de la España profunda frente a todo influjo foráneo. U. m. en sent. despect.
carraspeó	1. intr. Emitir una tosecilla repetidas veces a fin de aclarar la garganta y evitar el enronquecimiento de la voz. 2. intr. Sentir o padecer carraspera o aspereza de garganta.
cascaciruelas	1. m. y f. coloq. p. us. Persona inútil y despreciable. hacer lo que Cascaciruelas 1. loc. verb. coloq. Afanarse mucho por nada, o sin resultado equivalente al trabajo.
cascaruleta	1. f. cuchareta (‖ especie de trigo propia de Andalucía). 2. f. coloq. Ruido que se hace en los dientes, dándose golpes con la mano en la barbilla.
catecúmeno	1. m. y f. Persona que se está instruyendo en la doctrina y misterios de la fe católica, con el fin de recibir el bautismo. óleo de los catecúmenos
catecúmenos	1. m. y f. Persona que se está instruyendo en la doctrina y misterios de la fe católica, con el fin de recibir el bautismo. óleo de los catecúmenos
cavilaciones	 1. f. Acción y efecto de cavilar. 2. f. cavilosidad.
cayado	1. m. Palo o bastón corvo por la parte superior, especialmente el de los pastores para prender y retener las reses. 2. m. Báculo pastoral de los obispos.
cedazo	1. m. Instrumento compuesto de un aro y de una tela, por lo común de cerdas, más o menos clara, que cierra la parte inferior. Sirve para separar las partes sutiles de las gruesas de algunas cosas, como la harina, el suero, etc.
cenaoscuras	 1. m. y f. coloq. Persona huraña. 2. m. y f. coloq. Persona que por tacañería se priva de las comodidades regulares.
cenotafio	 1. m. Monumento funerario en el cual no está el cadáver del personaje a quien se dedica.
cenutria	 1. adj. coloq. Esp. Torpe o estúpido. U. t. c. s.
cenáculo	1. m. Rel. Sala en que Jesucristo celebró la última cena. 2. m. Reunión poco numerosa de personas unidas por vínculos ideológicos o profesionales, generalmente de escritores y artistas.
cerotea	 gotear.
cerril	 Que se obstina en una actitud o parecer, sin admitir trato ni razonamiento.
cerval	 Muy grande o excesivo. espino cerval gato cerval
chaparrón	 1. m. Lluvia recia de corta duración. 2. m. Abundancia o muchedumbre de algo. 3. m. And., Cuba, Hond. y P. Rico. Riña, regaño, reprimenda.
chirle	1. adj. coloq. Insípido, insustancial. 2. adj. Arg., Bol. y Ur. Falto de consistencia, blanduzco. 3. adj. Arg. y Ur. De poco interés, sin gracia.
chirlomirlo	 1. adj. Medio embriagado. 2. m. Cosa de poco alimento o sustancia. 3. m. Estribillo de cierto juego infantil. 4. m. Sal. tordo (‖ pájaro).
chollos	 1. m. coloq. Cosa valiosa o apreciable que se adquiere a muy bajo precio o con poco esfuerzo. U. t. en sent. irón.
chorroborro	 1. m. despect. Aluvión de cosas inútiles.
chozno	 1. m. y f. Hijo del tataranieto de una persona.
chumino	 1. m. malson. Esp. Vulva y vagina del aparato genital femenino.
chupóptero	 Que se aprovecha de otras. U. t. c. s.
cháchara	 1. f. Conversación frívola. 2. f. coloq. Abundancia de palabras inútiles. 3. f. pl. Baratijas, cachivaches.
ciegayernos	 1. m. coloq. Cosa de poco valor que aparenta tenerlo grande.
cieno	 1. m. Lodo blando que forma depósito en ríos, y sobre todo en lagunas o en sitios bajos y húmedos.
cierzos	 1. m. Viento septentrional más o menos inclinado a levante o a poniente, según la situación geográfica de la región en que sopla.
cipayo	 1. m. Soldado indio de los siglos XVIII y XIX al servicio de Francia, Portugal y Gran Bretaña. 2. m. despect. Secuaz a sueldo.
circunstantes	 Que está presente, asiste o concurre. U. t. c. s.
cisco	 1. m. Carbón vegetal menudo. 2. m. coloq. Bullicio, reyerta, alboroto. hacer cisco algo o a alguien 1. loc. verb. coloq. hacer trizas.
claque	1. f. Grupo de personas que asisten a un espectáculo con el fin de aplaudir en momentos señalados. La claque. 2. f. Grupo de personas que aplauden, defienden o alaban las acciones de otra buscando algún provecho.
coevos	 Que existieron en un mismo tiempo. Apl. a pers., u. t. c. s.
cofia	1. f. Prenda femenina de cabeza, generalmente blanca y de pequeño tamaño, que llevan enfermeras, camareras, criadas, etc., como complemento de su uniforme.
cojón	1. m. malson. coloq. testículo. cojones 1. interj. malson. coloq. U. para expresar diversos estados de ánimo, especialmente extrañeza o enfado.
colza	1. f. Especie de col que tiene las hojas inferiores algo ásperas, dentadas y liradas, y las superiores acorazonadas, y de cuyas semillas se extrae un aceite para usos industriales.
comilón	1. adj. coloq. Que come mucho o desordenadamente. U. t. c. s. 2. f. coloq. Comida muy abundante y variada. hártate, comilón, na, con pasa y media
comistrajo	 1. m. coloq. Mezcla irregular y extravagante de alimentos.
conciliábulo	 1. m. Concilio no convocado por autoridad legítima. 2. m. Junta o reunión para tratar de algo que se quiere mantener oculto.
conduélete	 1. tr. desus. compadecer. 2. prnl. compadecerse (‖ sentir lástima).
conllorar	 1. intr. Acompañar en el llanto o en el dolor. 2. intr. Asociarse al sentimiento de una desgracia.
contumaz	 Que se estima propia para retener y propagar los gérmenes de un contagio.
conturbaba	 1. tr. Alterar o inquietar a alguien o causar intranquilidad en su ánimo. U. t. c. prnl.
copón	1. m. Rel. En el culto católico, vaso sagrado en forma de copa grande, que contiene las hostias consagradas. del copón 1. loc. adj. malson. Muy grande, tremendo.
corderoy	 1. m. Arg., Bol. y Ur. Tela gruesa de algodón que se utiliza para confeccionar prendas de vestir.
coribante	 1. m. Sacerdote de Cibeles, que en las fiestas de esta diosa danzaba de forma orgiástica al son de ciertos instrumentos.
corifeos	1. m. Persona que es seguida por otras en una opinión, una ideología o un partido. 2. m. Seguidor o partidario. U. m. en pl. 3. m. En la tragedia griega, director del coro.
cortesía	1. f. Demostración o acto con que se manifiesta la atención, respeto o afecto que tiene alguien a otra persona. 2. f. En las cartas, expresiones de obsequio y urbanidad que se ponen antes de la firma.
cotila	 1. f. Anat. cotilo.
cotiledones	 1. m. Bot. Primera hoja del embrión de las plantas fanerógamas.
coña	1. f. coloq. Guasa, burla disimulada. 2. f. coloq. Cosa molesta. coña marinera 1. f. coloq. Esp. coña. ni de coña 1. loc. adv. coloq. Esp. de ninguna manera.
craquela	 1. tr. Producir finas grietas en la superficie de algo, a veces como procedimiento decorativo. U. t. c. prnl.
crematisticodialéctica	Versión electrónica 23.4 del «Diccionario de la lengua española», obra lexicográfica académica por excelencia.
cribados	Entradas que contienen la forma «cribados» | Diccionario de la lengua española | RAE - ASALE
crápula	 1. f. Disipación, libertinaje. 2. f. p. us. Embriaguez o borrachera. 3. m. Hombre de vida licenciosa.
cuchipanda	 1. f. coloq. Comida que toman juntas y regocijadamente varias personas.
culo	1. m. Conjunto de las dos nalgas. 2. m. En algunos animales, zona carnosa que rodea el ano. 3. m. ano. 4. m. Extremidad inferior o posterior de algunas cosas. Culo del pepino, del vaso.
currinche	 1. m. y f. Entre periodistas, principiante, gacetillero.
cuscurroextremo	Versión electrónica 23.4 del «Diccionario de la lengua española», obra lexicográfica académica por excelencia.
dawdle!	Versión electrónica 23.4 del «Diccionario de la lengua española», obra lexicográfica académica por excelencia.
decir	1. tr. Manifestar con palabras el pensamiento. U. t. c. prnl. 2. tr. Asegurar, sostener, opinar. 3. tr. Nombrar o llamar. 4. tr. Denotar algo o dar muestras de ello. El semblante de Juan dice su mal genio. Su vestido dice su pobreza.
deferencia	1. f. Adhesión al dictamen o proceder ajeno, por respeto o por excesiva moderación. 2. f. Muestra de respeto o de cortesía. 3. f. Conducta condescendiente.
dehesa	1. f. Tierra generalmente acotada y arbolada, por lo común destinada a pastos. dehesa carneril 1. f. dehesa en que pastan carneros. dehesa potril
deneí	Versión electrónica 23.4 del «Diccionario de la lengua española», obra lexicográfica académica por excelencia.
denuedo	 1. m. Brío, esfuerzo, valor, intrepidez.
derrelicto	 1. m. Mar. Buque u objeto abandonado en el mar.
desabrido	 Que es fuerte y dura al disparar, de manera que da coz o golpe al tirador.
desamorrar	1. tr. coloq. Hacer que alguien levante la cabeza o que, dejando el silencio en que estaba, responda y converse con quienes están presentes.
desdar	1. tr. Dar vueltas, en sentido inverso, a un manubrio, carrete o cuerda para deshacer otras vueltas anteriores. 2. tr. desabrochar (‖ desasir los broches o corchetes).
deshonrabuenos	1. m. y f. coloq. desus. Persona que murmura de otros, desacreditándolos y poniéndolos en mala opinión sin razón ni verdad. 2. m. y f. coloq. desus. Persona que degenera con respecto a sus mayores.
desopilante	 1. adj. Festivo, divertido, que produce mucha risa.
despidida	 1. f. rur. Ar. Salida, desaguadero.
diente	1. m. Cuerpo duro que, engastado en las mandíbulas del hombre y de muchos animales, queda descubierto en parte, para servir como órgano de masticación o de defensa.
digitígrado	 Que al andar apoya solo los dedos; p. ej., el gato.
dinamómetro	 1. m. Mec. Instrumento para medir fuerzas, basado en la deformación elástica de un muelle calibrado.
ditirambo	1. m. Alabanza exagerada, encomio excesivo. 2. m. En la antigua Grecia, composición poética en loor de Dioniso. 3. m. Composición poética, comúnmente de carácter laudatorio, a semejanza del ditirambo griego.
ditirámbica	 1. adj. Perteneciente o relativo al ditirambo.
dogal	1. m. Cuerda o soga de la cual con un nudo se forma un lazo para atar las caballerías por el cuello. 2. m. Cuerda para ahorcar a un reo o para algún otro suplicio.
donosa	 1. adj. Que tiene donaire y gracia. U. t. en sent. irón. Donosa ocurrencia, pregunta.
dígrafos	 1. m. Ling. Secuencia de dos letras que representa un solo sonido; p. ej., en español ll, en francés ou, en catalán ny.
díscolos	 1. adj. Desobediente, que no se comporta con docilidad. U. t. c. s.
egregio	 1. adj. Insigne, ilustre.
elipsis	1. f. Gram. Omisión de un segmento sintáctico cuyo contenido se puede recuperar por el contexto; p. ej., en Juan estudia biología y María (estudia) matemáticas.
en	1. prep. Denota en qué lugar, tiempo o modo se realiza lo expresado por el verbo a que se refiere. Pedro está en Madrid. Esto sucedió en Pascua. Tener en adobo.
encaratularsE	 1. prnl. Cubrirse la cara con mascarilla o carátula.
enfebrecida	1. adj. coloq. calenturiento (‖ que tiene calentura). 2. adj. Exaltado, arrebatado de una pasión. Imaginación enfebrecida. Discurso enfebrecido.
engastado	 1. tr. Encajar y embutir algo en otra cosa. Engastar una esmeralda en oro. U. t. en sent. fig.
enhebrando	1. tr. Pasar la hebra por el ojo de la aguja o por el agujero de las cuentas, perlas, etc. 2. tr. coloq. Decir seguidas muchas cosas sin orden ni concierto.
ennudecer	 Dejar de crecer.
entresijo	 Tener muchas dificultades o enredos no fáciles de entender o desatar.
epatar	 1. tr. Producir asombro o admiración. U. t. c. intr.
ermita	 1. f. Capilla o santuario, generalmente pequeños, situados por lo común en despoblado y que no suelen tener culto permanente.
errabunda	 1. adj. Que va de una parte a otra sin tener asiento fijo.
escaque	1. m. Cada una de las casillas cuadradas e iguales, blancas y negras alternadamente, y a veces de otros colores, en que se divide el tablero de ajedrez y el del juego de damas.
escayola	1. f. Yeso fino calcinado, utilizado en construcción para fabricar placas y elementos ornamentales y, en medicina, para endurecer vendajes.
escolios	 1. m. Nota que se pone a un texto para explicarlo.
espantanublados	1. m. coloq. Persona inoportuna que interrumpe una conversación o descompone un proyecto. 2. m. coloq. Tunante que andaba con hábitos largos por los lugares, pidiendo de puerta en puerta y haciendo creer a la gente rústica que tenía poder sobre los nublados.
espetó	1. tr. Atravesar con el asador, u otro instrumento puntiagudo, carne, aves, pescados, etc., para asarlos. 2. tr. Atravesar, clavar, meter por un cuerpo un instrumento puntiagudo.
espuertas	1. f. Especie de cesta de esparto, palma u otra materia, con dos asas, que sirve para llevar de una parte a otra escombros, tierra u otras cosas semejantes.
estabulamos	 1. tr. Meter y guardar ganado en establos.
estomagados	 1. tr. Causar indigestión, empachar, ahitar. 2. tr. Causar fastidio o enfado. Su presunción me estomaga.
estraperlistas	 1. m. y f. coloq. Persona que practica el estraperlo (‖ comercio ilegal).
estípite	1. m. Arq. Pilastra en forma de pirámide truncada invertida, con un elemento figurativo en la parte superior. 2. m. Bot. Tallo largo y no ramificado de las plantas arbóreas, especialmente de las palmeras.
estólido	 1. adj. Falto de razón y discurso. U. t. c. s.
etiología	1. f. Fil. Estudio sobre las causas de las cosas. 2. f. Med. Estudio de las causas de las enfermedades. 3. f. Med. Conjunto de causas de una enfermedad.
exigua	 1. adj. Insuficiente, escaso.
exiguos	 1. adj. Insuficiente, escaso.
expósito	 Abandonado o expuesto, o confiado a un establecimiento benéfico. U. m. c. s. casa de expósitos
fagot	1. m. Instrumento musical de viento, formado por un tubo de madera de unos siete centímetros de grueso y más de un metro de largo, con agujeros y llaves, y con una boquilla de caña puesta en un tudel.
fallero	1. adj. Perteneciente o relativo a las fallas3. 2. m. y f. Persona que por oficio construye las fallas que han de quemarse en las fiestas de San José en Valencia.
faltriquera	1. f. Bolsillo de las prendas de vestir. 2. f. Bolsa de tela que se ata a la cintura y se lleva colgando bajo la vestimenta. 3. f. cubillo (‖ aposento de los antiguos teatros de Madrid).
fiambrera	1. f. Recipiente con tapa bien ajustada, que sirve para guardar comida o llevarla fuera de casa. 2. f. Cestón o caja para llevar la provisión de alimentos fríos.
figón	 1. m. Casa de poca categoría, donde se guisan y venden cosas de comer. 2. m. desus. figonero.
filatería	1. f. Palabrería que usan los embaucadores para engañar y persuadir de lo que quieren. 2. f. Demasía de palabras para explicar o dar a entender un concepto.
fodolí	 1. adj. desus. Entremetido, hablador, que pretende aconsejar, mandar o intervenir donde no lo llaman.
follón	1. adj. p. us. Flojo, perezoso y negligente. U. t. c. s. 2. adj. p. us. Vano, arrogante, cobarde y de ruin proceder. U. t. c. s. 3. m. Cohete que se dispara sin trueno.
frigidísimo	 1. adj. sup. cult. de frío.
frontispicio	1. m. Fachada o delantera de un edificio, mueble u otra cosa. 2. m. Página de un libro anterior a la portada, que suele contener el título y algún grabado o viñeta.
fruición	 1. f. Goce muy vivo en el bien que alguien posee. 2. f. Complacencia, goce. El malvado tiene fruición en ver llorar.
fundón	Versión electrónica 23.4 del «Diccionario de la lengua española», obra lexicográfica académica por excelencia.
fuña	Versión electrónica 23.4 del «Diccionario de la lengua española», obra lexicográfica académica por excelencia.
fámula	 1. m. y f. coloq. Criado doméstico. 2. m. Sirviente de la comunidad de un colegio.
fárrago	 1. m. Cúmulo de ideas o expresiones confusas, inconexas o superfluas. 2. m. Montón de cosas desordenadas.
férvidos	 1. adj. Que hierve. 2. adj. Que arde. 3. adj. Que causa ardor.
gambito	1. m. En el juego de ajedrez, lance que consiste en sacrificar, al principio de la partida, algún peón u otra pieza, o ambos, para lograr una posición favorable.
gandumbas	 1. adj. coloq. Haragán, dejado, apático. U. t. c. s. 2. f. pl. testículos.
garambaina	1. f. Adorno de mal gusto y superfluo en los vestidos u otras cosas. 2. f. pl. coloq. Ademanes afectados o ridículos. 3. f. pl. coloq. Letras o rasgos mal formados y que no se pueden leer.
gargaleote	Versión electrónica 23.4 del «Diccionario de la lengua española», obra lexicográfica académica por excelencia.
garullada	 1. f. coloq. Conjunto desordenado de gente.
gazmoñerías	 1. f. Afectación de modestia, devoción o escrúpulos.
gañanes	 1. m. Mozo de labranza. 2. m. Hombre fuerte y rudo.
glacis	 1. m. Mil. En una fortificación permanente, declive desde el camino cubierto hacia el campo.
golondro	1. m. Deseo y antojo de algo. andar en golondros 1. loc. verb. coloq. desus. Andar desvanecido, con esperanzas peligrosas e inútiles. campar de golondro
gotoso	 Que tiene torpes los pies por enfermedad.
guaperas	 1. adj. despect. coloq. Guapo y presumido. U. t. c. s. m.
guata	1. f. Lámina gruesa de algodón en rama, engomada por ambas caras, que sirve para acolchados o como material de relleno. 1. f. coloq. Arg., Bol., Chile, Ec. y Perú. Barriga, vientre, panza.
guedejas	1. f. Cabellera larga. 2. f. mechón. 3. f. Melena del león. tener algo por la guedeja 1. loc. verb. No dejar escapar la ocasión de lograrlo.
guinda	1. f. Fruto del guindo. 2. f. coloq. Cosa que remata o culmina algo. 3. f. El Salv. Huida a la carrera. 4. m. despect. coloq. p. us. guindilla (‖ agente de policía).
habón	 1. m. Bulto en forma de haba que causa picor y aparece en la piel producido por la picadura de un insecto, por urticaria, etc.
hala	1. interj. U. para infundir aliento o meter prisa. 2. interj. U. para mostrar sorpresa. 3. interj. U. para llamar. 4. interj. U. para denotar la persistencia en una marcha. U. repetida.
hale	 1. interj. hala.
haplología	1. f. Ecd. haplografía. 2. f. Ling. Eliminación de una sílaba semejante a otra contigua de la misma palabra; p. ej., cejunto por cejijunto, impudicia por impudicicia.
hatajo	 1. m. Grupo pequeño de ganado. 2. m. despect. Grupo de personas o cosas. Un hatajo de pillos, de disparates.
henchido	1. tr. Llenar un espacio o un recipiente hasta su límite. El viento henchía las velas. U. t. c. prnl. U. t. en sent. fig. Henchirse de gozo.
herma	 1. m. Busto sin brazos colocado sobre un estípite.
higa	1. f. Dije de azabache o coral, en forma de puño, que ponen a los niños con la idea de librarlos del mal de ojo. 2. f. Gesto que se ejecuta con la mano, cerrado el puño, mostrando el dedo pulgar por entre el dedo índice y el cordial, con el que se señalaba a las personas infames o se hacía desprecio de ellas.
himenópteros	 Que es masticador y lamedor a la vez, por estar provista su boca tanto de mandíbulas como de una especie de lengüeta, que tiene en el extremo del abdomen, en la hembra de algunas especies, un aguijón en el que desemboca el conducto excretor de una glándula venenosa, y que tiene cuatro alas membranosas y metamorfosis complicada; p. ej., la abeja y la avispa. U. t. c. s. m., en pl. como taxón.
hiperónimo	 1. m. Ling. Palabra cuyo significado está incluido en el de otras. Pájaro es hiperónimo de jilguero y de gorrión.
homúnculo	 1. m. cult. Hombre pequeño. U. t. en sent. despect.
hordimbre	Versión electrónica 23.4 del «Diccionario de la lengua española», obra lexicográfica académica por excelencia.
horros	 Que no quedan preñadas.
horteras	1. adj. despect. coloq. Vulgar y de mal gusto. Apl. a pers., u. t. c. s. 2. f. Escudilla o cazuela de palo. 3. m. En Madrid, apodo del mancebo de ciertas tiendas de mercader.
hueco	1. adj. Que tiene vacío el interior. Esta columna está hueca. 2. adj. Que tiene sonido retumbante y profundo. Voz hueca. 3. adj. Mullido y esponjoso. Tierra, lana hueca.
huero	 1. adj. Vano, vacío y sin sustancia. salir huero, ra algo 1. loc. verb. coloq. frustrarse (‖ malograrse). huevo huero V. güero2.
ignaras	 1. adj. Que no tiene noticia de las cosas.
ignoto	 1. adj. No conocido ni descubierto.
impasible	 1. adj. Incapaz de padecer o sentir. 2. adj. Indiferente, imperturbable.
impetró	 1. tr. Conseguir una gracia que se ha solicitado y pedido con ruegos. 2. tr. Solicitar una gracia con encarecimiento y ahínco.
incordio	 1. m. buba (‖ tumor blando). 2. m. buba (‖ tumor de origen no venéreo). 3. m. coloq. Persona o cosa incómoda, agobiante o muy molesta.
individuo	 1. adj. individual. 2. adj. Que no puede ser dividido. 3. m. y f. coloq. Persona cuyo nombre y condición se ignoran o no se quieren decir.
inefables	 1. adj. Que no se puede explicar con palabras.
ingentes	 1. adj. Muy grande.
inocuas	 1. adj. Que no hace daño.
inopia	 1. f. cult. Indigencia, pobreza, escasez. en la inopia 1. loc. adv. coloq. En la más absoluta ignorancia de algo.
intonsasilfo	Versión electrónica 23.4 del «Diccionario de la lengua española», obra lexicográfica académica por excelencia.
intrusismo	 1. m. Ejercicio de actividades profesionales por persona no autorizada para ello. Puede constituir delito.
invectiva	 1. f. Discurso o escrito acre y violento contra alguien o algo.
isba	 1. f. Vivienda rural de madera, propia de algunos países septentrionales del antiguo continente, y especialmente de Rusia.
islilla	 1. f. p. us. Sobaco del cuerpo humano. 2. f. p. us. Clavícula del cuerpo humano.
izquierdear	 1. intr. desus. Apartarse de lo que dictan la razón y el juicio.
jamaquión	 1. m. El Salv. y Nic. Movimiento fuerte de la tierra. 2. m. Nic. Tirón que da el dentista al extraer una muela.
jubón	1. m. Vestidura que cubría desde los hombros hasta la cintura, ceñida y ajustada al cuerpo. 2. m. coloq. jubón de azotes. jubón de azotes 1. m. coloq. Azotes que por justicia se daban en las espaldas.
juzgamundos	 1. m. y f. coloq. Persona murmuradora.
lambucear	 1. intr. Lamer, por glotonería, un plato o una vasija.
leche	1. f. Líquido blanco que segregan las mamas de las hembras de los mamíferos para alimento de sus crías. 2. f. leche de algunos animales que se emplea como alimento de las personas.
letra	1. f. Cada uno de los signos gráficos que componen el alfabeto de un idioma. 2. f. En la tradición gramatical, cada uno de los sonidos de un idioma.
libar	 Sorber suavemente el jugo de las flores. U. t. c. intr. 2. tr. Hacer la libación para el sacrificio o la presentación de ofrendas a alguna divinidad.
librea	1. f. Traje que los príncipes, señores y algunas otras personas o entidades dan a sus criados; por lo común, uniforme y con distintivos. 2. f. Paje o criado que usa librea.
liminar	 1. adj. Perteneciente o relativo al umbral o a la entrada. 2. adj. preliminar (‖ que sirve de preámbulo).
lisonja	 1. f. Alabanza afectada para ganar la voluntad de alguien. 1. f. Heráld. losange.
lluviano	 Recién mojado por la lluvia.
longanimidad	 1. f. Grandeza y constancia de ánimo en las adversidades. 2. f. Benignidad, clemencia, generosidad.
loor	 1. m. elogio.
láudano	1. m. Preparación compuesta de vino blanco, opio, azafrán y otras sustancias. 2. m. Extracto de opio. 3. m. desus. opio (‖ extracto de la adormidera).
macarras	 Agresiva, achulada. U. t. c. s. 2. adj. Vulgar, de mal gusto. Apl. a pers., u. t. c. s. 3. m. rufián (‖ hombre dedicado al tráfico de la prostitución).
macilento	 1. adj. Flaco y descolorido.
macuto	1. m. Mochila, especialmente la del soldado. 2. m. Ven. Cesto tejido de caña amarga, de forma cilíndrica y con asa en la boca, que se usa para transportar víveres y otros objetos.
maestresala	1. m. y f. En los comedores de hoteles y ciertos restaurantes, jefe de camareros que dirige el servicio de las mesas. 2. m. Criado principal que asistía a la mesa de un señor, presentaba y distribuía la comida y la probaba para garantizar que no contenía veneno.
mama	1. f. Anat. Órgano glanduloso y saliente que los mamíferos tienen en número par y sirve en las hembras para la secreción de la leche. 2. f. pop. mamá. U. t. en leng. infant.
manida	 1. f. p. us. Lugar donde una persona o animal se refugia.
mantequitas	Versión electrónica 23.4 del «Diccionario de la lengua española», obra lexicográfica académica por excelencia.
manumitir	 1. tr. Dar libertad a un esclavo.
maquis	1. m. Guerrilla francesa de resistencia contra la ocupación alemana durante la Segunda Guerra Mundial. 2. m. Guerrilla de resistencia antifranquista durante la posguerra civil española.
marabunta	1. f. Población masiva de ciertas hormigas migratorias, que devoran a su paso todo lo comestible que encuentran. 2. f. Conjunto de gente alborotada y tumultuosa.
marinovio	1. m. y f. coloq. Cuba. Persona con quien se mantiene una relación amorosa y sexual estable sin casarse. En Ven., u. solo el m. 2. m. pl. El Salv. Novios que viven como marido y mujer.
marisabidillas	 1. m. y f. coloq. Persona que presume de sabia.
meapilas	 1. m. santurrón.
medalaganariamente	Versión electrónica 23.4 del «Diccionario de la lengua española», obra lexicográfica académica por excelencia.
meliflua	1. adj. Que tiene miel o es parecido a ella en sus propiedades. 2. adj. Dulce, suave, delicado y tierno en el trato o en la manera de hablar. U. m. en sent. peyor.
melindres	1. m. Delicadeza afectada y excesiva en palabras, acciones y ademanes. U. m. en pl. 2. m. Fruta de sartén, hecha con miel y harina. 3. m. Dulce de pasta de mazapán con baño espeso de azúcar blanco, generalmente en forma de rosquilla muy pequeña.
mirífico	 1. adj. poét. Admirable, maravilloso.
miríficos	 1. adj. poét. Admirable, maravilloso.
mofletudo	 1. adj. Que tiene mofletes.
mojamacecina	Versión electrónica 23.4 del «Diccionario de la lengua española», obra lexicográfica académica por excelencia.
molicie	 1. f. Blandura de las cosas al tacto. 2. f. Abandono invencible al placer de los sentidos o a una grata pereza.
molón	1. m. Ál. Piedra grande de forma irregular y redondeada que se desprende de la cantera al barrenar. 2. m. Ál. y Ec. Trozo de piedra sin labrar.
mondos	 1. adj. Limpio y libre de cosas añadidas o superfluas. mondo, da y lirondo, da 1. loc. adj. coloq. Limpio, sin añadidura alguna.
monta	1. f. Acción y efecto de montar. 2. f. Sitio en que el caballo o burro cubre a la yegua. 3. f. Suma de varias partidas. 4. f. Valor, calidad y estimación intrínseca de algo.
montaraz	 Agreste, grosero y feroz.
morralla	1. f. Conjunto o mezcla de cosas inútiles y despreciables. 2. f. Multitud de gente de escaso valer. 3. f. Pescado menudo. 4. f. Hond. y Méx. calderilla (‖ monedas de escaso valor).
morube	Versión electrónica 23.4 del «Diccionario de la lengua española», obra lexicográfica académica por excelencia.
motejan	 1. tr. Notar, censurar las acciones de alguien con motes o apodos.
munificentes	 1. adj. Que ejerce munificencia.
muñe	 1. tr. Concertar, disponer, manejar las voluntades de otros. 2. tr. Llamar o convocar a las juntas o a otra cosa.
mímesis	1. f. En la estética clásica, imitación de la naturaleza que como finalidad esencial tiene el arte. 2. f. Imitación del modo de hablar, gestos y ademanes de una persona.
nefandas	 Que causa repugnancia u horror hablar de ella. pecado nefando
nefelibata	 Soñadora, que no se apercibe de la realidad. U. t. c. s.
nenúfares	1. m. Planta acuática de la familia de las ninfeáceas, con rizoma largo, nudoso y feculento, hojas enteras, casi redondas, de pecíolo central y tan largo que, saliendo del rizoma, llega a la superficie del agua, donde flota la hoja; flores blancas, terminales y solitarias, y fruto globoso, capsular, con muchas semillas pequeñas, elipsoidales y negruzcas.
ni	1. conj. copulat. U. para coordinar de manera aditiva vocablos o frases que denotan negación, precedida o seguida de otra u otras igualmente negativas. No como ni duermo. Nada hizo ni dejó hacer a los demás. Nunca faltes a tu deber ni prefieras a la honra el provecho. A nadie quiso recibir, ni a sus más íntimos amigos. Ni lo sé ni quiero saberlo. Ni Juan, ni Pedro ni Felipe te darán la razón.
nieve	1. f. Agua helada que se desprende de las nubes en cristales sumamente pequeños, los cuales, agrupándose al caer, llegan al suelo en copos blancos.
nombradía	 1. f. Fama, reputación.
odres	1. m. Cuero, generalmente de cabra, que, cosido y empegado por todas partes menos por la correspondiente al cuello del animal, sirve para contener líquidos, como vino o aceite.
ofidios	 Que carece de extremidades, con boca dilatable y cuerpo largo y estrecho revestido de una epidermis escamosa que muda todos los años, y que es venenoso en algunas especies; p. ej., la víbora. U. t. c. s. m., en pl. como taxón.
ojeriza	 1. f. Enojo y mala voluntad contra alguien.
ojizaino	 1. adj. coloq. Que mira atravesado y con malos ojos.
omitir	 1. tr. Abstenerse de hacer algo. 2. tr. Pasar en silencio algo. U. t. c. prnl.
opíparamente	 1. adv. De manera opípara.
opíparas	 1. adj. Copioso y espléndido. U. m. referido a una comida o un banquete.
ordimbre	Versión electrónica 23.4 del «Diccionario de la lengua española», obra lexicográfica académica por excelencia.
oíslo	 1. m. y f. coloq. p. us. cónyuge.
pacata	1. adj. timorato (‖ tímido). Tomás es algo pacato. U. t. c. s. 2. adj. De poco valor, insignificante. 3. adj. Mojigato, que tiene o manifiesta excesivos escrúpulos. U. t. c. s.
padrejón	 1. m. Histerismo en el hombre.
palafreneros	1. m. Criado que lleva del freno el caballo. 2. m. Mozo de caballos. 3. m. Criado que monta el palafrén. palafrenero mayor 1. m. En las caballerizas reales, picador, jefe de la regalada, que tenía de la cabezada el caballo cuando montaba el rey.
palurdo	 Rústica e ignorante. U. t. c. s. 2. adj. despect. Propio o característico de la persona palurda.
panegírico	1. adj. Perteneciente o relativo al panegírico. 2. m. En oratoria, discurso o sermón en alabanza de algo o de alguien. 3. m. Elogio enfático de algo o de alguien.
paniaguados	1. m. y f. Persona que servía en una casa y recibía del dueño de ella habitación, alimento y salario. Era u. t. c. adj. 2. m. y f. despect. Persona allegada a otra y favorecida por ella. U. t. c. adj.
papelonear	1. intr. coloq. p. us. Ostentar vanamente autoridad o valimiento. 2. prnl. coloq. Ven. Confundirse, enredarse al hablar o al actuar. 3. prnl. coloq. Ven. acobardarse.
paragoge	 1. f. Fon. Adición de algún sonido al final de una palabra, como en clube por club o en male por mal.
pardillos	 Incauta, que se deja estafar fácilmente. U. t. c. s.
pardillos—ignorante	Versión electrónica 23.4 del «Diccionario de la lengua española», obra lexicográfica académica por excelencia.
paripé	 1. m. coloq. Fingimiento, simulación o acto hipócrita. hacer el paripé 1. loc. verb. coloq. Presumir, darse tono.
parlaembalde	 1. m. y f. coloq. Persona que habla mucho y sin sustancia.
paroxismo	1. m. Exaltación extrema de los afectos y pasiones. 2. m. Med. Exacerbación de una enfermedad. 3. m. Med. Accidente peligroso o casi mortal, en que el paciente pierde el sentido y la acción por largo tiempo.
partenogénesis	1. f. Biol. Modo de reproducción de algunos animales y plantas, que consiste en la formación de un nuevo ser por división reiterada de células sexuales femeninas que no se han unido previamente con gametos masculinos.
parterre	 1. m. Jardín o parte de él con césped, flores y anchos paseos.
patena	1. f. En el rito católico, bandeja pequeña, generalmente dorada, donde se deposita la hostia durante la celebración eucarística. 2. f. Lámina o medalla grande que se usaba como alhaja o adorno.
peculio	1. m. Dinero y bienes propios de una persona. 2. m. Hacienda o caudal que el padre o señor permitía al hijo o siervo para su uso y comercio.
pedernal	 1. m. Variedad de cuarzo, compacto, traslúcido en los bordes y que produce chispas al ser golpeado. 2. m. Suma dureza en cualquier cosa.
pegujal	1. m. Pequeña porción de siembra o de ganado. 2. m. Pequeña porción de terreno que el dueño de una finca agrícola cede al guarda o al encargado para que la cultive por su cuenta como parte de su remuneración anual.
pelandusca	 1. f. despect. coloq. prostituta. 2. f. despect. coloq. Mujer de costumbres sexuales muy libres.
perdularia	1. adj. Que pierde las cosas frecuentemente. U. t. c. s. 2. adj. Sumamente descuidado en sus intereses o en su persona. U. t. c. s. 3. adj. Vicioso incorregible. U. t. c. s.
pergeñan	 1. tr. coloq. Disponer o ejecutar algo con más o menos habilidad.
perifasis	Versión electrónica 23.4 del «Diccionario de la lengua española», obra lexicográfica académica por excelencia.
perifollos	1. m. Planta herbácea anual, de la familia de las umbelíferas, con tallos de 30 a 40 cm de altura, finos, ramosos, huecos y estriados, hojas muy recortadas en lóbulos lanceolados, flores blancas en umbelas pequeñas, y semilla menuda, negra, aovada, puntiaguda y estriada, que se cultiva en las huertas por usarse como condimento las hojas, que son aromáticas y de gusto agradable.
perillanes	 1. m. y f. coloq. Persona pícara, astuta. U. t. c. adj.
perillán	 1. m. y f. coloq. Persona pícara, astuta. U. t. c. adj.
perjuro	1. adj. Que jura en falso. U. t. c. s. 2. adj. Que quebranta maliciosamente el juramento que ha hecho. U. t. c. s. 3. m. p. us. Acción y efecto de perjurar.
persona	1. f. Individuo de la especie humana. 2. f. Hombre o mujer cuyo nombre se ignora o se omite. 3. f. Hombre o mujer distinguidos en la vida pública.
perspicuo	 inteligible (‖ que puede ser entendido).
perífasis	Versión electrónica 23.4 del «Diccionario de la lengua española», obra lexicográfica académica por excelencia.
perífrasis	1. f. Gram. Expresión pluriverbal cuyo significado se asimila parcialmente al de una unidad léxica. La perífrasis echar una conversada se asimila al verbo conversar.
peteneras	1. f. Palo flamenco parecido a la malagueña, con que se cantan coplas de cuatro versos octosílabos. salir, o salirse, por peteneras 1. locs. verbs. coloqs. Desviar el discurso con una incongruencia, frecuentemente para no pronunciarse en una cuestión comprometida.
petimetre	 1. m. y f. Persona que se preocupa mucho de su compostura y de seguir las modas.
piadoso	 Que mueve a compasión o se origina de ella.
piaras	Entradas que contienen la forma «piaras» | Diccionario de la lengua española | RAE - ASALE
pibón	 1. m. coloq. Esp. Persona muy atractiva.
pienso	 Con piensos.
pifostio	Versión electrónica 23.4 del «Diccionario de la lengua española», obra lexicográfica académica por excelencia.
pipiar	 Dar voces cuando son pequeñas.
pisaverde	1. m. coloq. Hombre presumido y afeminado, que no conoce más ocupación que la de acicalarse, perfumarse y andar vagando todo el día en busca de galanteos.
plantígrado	 Cuadrúpedo que al andar apoya en el suelo toda la planta de los pies y las manos; p. ej., el oso o el tejón. U. t. c. s.
pluguiera	1. intr. Agradar o dar gusto. que me place 1. expr. Denota que algo agrada o se aprueba. 1. m. Goce o disfrute físico o espiritual producido por la realización o la percepción de algo que gusta o se considera bueno. 2. m. Diversión, entretenimiento.
plúteo	 1. m. Cada uno de los cajones o tablas de un estante o armario de libros.
poetastros	 1. m. y f. Mal poeta.
polímatas	 1. m. y f. Persona con grandes conocimientos en diversas materias científicas o humanísticas.
porfiada	 Terca y obstinada en su dictamen y parecer. U. t. c. s. 2. adj. De manera propia de la persona porfiada. 3. m. C. Rica. tentetieso.
porfiado	 Terca y obstinada en su dictamen y parecer. U. t. c. s. 2. adj. De manera propia de la persona porfiada. 3. m. C. Rica. tentetieso.
porfías	Entradas que contienen la forma «porfías» | Diccionario de la lengua española | RAE - ASALE
preceptor	 1. m. y f. Persona que enseña. 2. m. y f. Persona que enseñaba gramática latina.
precesión	1. f. Mec. Movimiento de rotación del eje inclinado de giro de un giróscopo, como el de un trompo. 2. f. Ret. Enunciación de una frase que se deja incompleta para que se sobrentienda.
premiosos	 Que habla o escribe con mucha dificultad.
proemio	 1. m. Prólogo, discurso antepuesto al cuerpo de un libro.
prognato	 Que tiene salientes las mandíbulas. U. t. c. s.
progresía	 1. f. coloq. Condición de progresista (‖ de ideas avanzadas). 2. f. irón. coloq. Conjunto de personas progresistas (‖ de ideas avanzadas).
provectos	 De edad avanzada. 2. adj. cult. Propio de una persona provecta. Edad provecta. Provectos años.
pródigo	 Que desperdicia y consume su hacienda en gastos inútiles, sin medida ni razón. U. t. c. s. 2. adj. Que desprecia generosamente la vida u otra cosa estimable.
puchero	1. m. Vasija de barro o de otros materiales, con asiento pequeño, panza abultada, cuello ancho, una sola asa junto a la boca, y, por ext., otros tipos de vasija.
pullas	Entradas que contienen la forma «pullas» | Diccionario de la lengua española | RAE - ASALE
pulverulento	 1. adj. En estado de polvo. Sustancia pulverulenta. 2. adj. p. us. polvoriento.
putiferio	1. m. coloq. puterío (‖ prostitución). 2. m. coloq. puterío (‖ conjunto de personas que ejercen la prostitución). 3. m. coloq. puterío (‖ situación de desmadre).
pérfido	 1. adj. Desleal, infiel, traidor, que falta a la fe que debe. U. t. c. s.
que	1. pron. relat. m., f. y n. Introduce una oración relativa y refiere a un antecedente expreso, generalmente nominal. Se pondrá los vestidos que tú elijas. Ella, que finalmente no vino, tenía un compromiso.
quichicientos	Versión electrónica 23.4 del «Diccionario de la lengua española», obra lexicográfica académica por excelencia.
quiroteca	 1. f. guante (‖ prenda para cubrir la mano).
quita	1. f. Der. Remisión o liberación que de la deuda o parte de ella hace el acreedor al deudor. quita y espera 1. f. Der. Petición que un deudor hace judicialmente a todos sus acreedores, bien para que estos aminoren los créditos o aplacen el cobro, o bien para una u otra de ambas concesiones.
rapapolvos	 1. m. coloq. Reprensión áspera.
recusamos	 1. tr. No querer admitir o aceptar algo. 2. tr. Der. Ejercitar la recusación.
redaños	 1. m. Anat. mesenterio. 2. m. pl. Fuerzas, bríos, valor.
regicida	 Que atenta contra la vida del soberano, aunque no consume el hecho. U. t. c. s.
remediavagos	1. m. Libro o manual que resume una materia en poco espacio, para facilitar su estudio. 2. m. Procedimiento destinado a hacer algo con el mínimo esfuerzo.
remolacha	1. f. Planta herbácea anual, de la familia de las quenopodiáceas, con tallo derecho, grueso, ramoso, de uno a dos metros de altura, hojas grandes, enteras, ovales, con nervio central rojizo, flores pequeñas y verdosas en espiga terminal, fruto seco con una semilla lenticular, y raíz grande, carnosa, fusiforme, generalmente encarnada, que es comestible y de la cual se extrae azúcar.
reptaba	 1. tr. desus. Desafiar, retar a alguien. 1. intr. Andar arrastrándose como algunos reptiles.
requeté	1. m. En las guerras civiles españolas de los siglos XIX y XX, cuerpo de voluntarios que luchaba en defensa de la tradición religiosa y de la monarquía carlista.
requilorios	1. m. Adorno o complemento excesivo o innecesario. U. m. en pl. 2. m. coloq. Formalidad e innecesario rodeo en que suele perderse el tiempo antes de hacer o decir lo que es obvio, fácil y sencillo. U. m. en pl.
resma	 1. f. Conjunto de 20 manos de papel. resma sucia 1. f. resma de papel de hilo, que tiene sus dos costeras correspondientes.
retobo	1. adj. Col. Grueso y de poca altura. 2. m. Arg., Chile y Ur. Acción y efecto de retobar. 3. m. Chile. Arpillera, tela basta o encerado con que se retoba.
retobón	Versión electrónica 23.4 del «Diccionario de la lengua española», obra lexicográfica académica por excelencia.
retortero	1. m. Vuelta alrededor. 2. m. And. Cerco, mancha que rodea algo. al retortero 1. loc. adv. alrededor. andar al retortero 1. loc. verb. coloq. Andar sin sosiego de acá para allá.
retruécanos	1. m. Juego con las palabras en que se suele producir una repetición. 2. m. Ret. Inversión de los términos de una proposición o cláusula en la siguiente para que el sentido de esta última forme contraste o antítesis con el de la primera, como en ¿Siempre se ha de sentir lo que se dice? ¿Nunca se ha de decir lo que se siente?
reyertas	 1. f. Contienda, altercación o cuestión.
rifirrafe	 1. m. coloq. Contienda o bulla ligera y sin trascendencia.
rilar	 1. intr. Temblar, tiritar. 2. prnl. Temblar, vibrar.
rosicler	 Rosa claro y suave, semejante al de la aurora. U. m. c. s. m. 3. adj. poét. De color rosicler.
roznando	 1. tr. Comer con ruido. 2. tr. Mover una cosa pesada ladeándola con palancas. 3. intr. rebuznar.
réprobos	 Apartada de la convivencia por razones distintas de las religiosas. U. t. c. s.
rúa	1. f. Calle de un pueblo. 2. f. camino carretero (‖ camino para el tránsito de carruajes). 3. f. En Galicia, fiesta o diversión nocturna de aldeanos.
sabañones	1. m. Hinchazón o ulceración de la piel, principalmente de las manos, los pies y las orejas, que es causada por frío excesivo y produce ardor y picazón.
salmodiaba	 1. tr. Cantar algo con cadencia monótona. 2. intr. Cantar salmodias.
salvohonor	 1. m. coloq. culo (‖ nalgas).
sandios	 1. adj. Necio o simple. U. t. c. s.
sangradura	1. f. Parte hundida del brazo opuesta al codo. 2. f. Corte o punción de la vena para sacar sangre. 3. f. Salida que se da a las aguas de un río o canal o de un terreno encharcado.
sapitos	1. m. Arg., Chile y Ur. Bote que dan las piedras lanzadas sobre la superficie del agua. 2. m. El Salv. Señal de tráfico consistente en un hito de piedra, que a veces tiene un reflectante.
sarabanda	Versión electrónica 23.4 del «Diccionario de la lengua española», obra lexicográfica académica por excelencia.
sarracina	 V. sarracino.
sarracino	1. adj. sarraceno. U. t. c. s. 2. f. Pelea entre muchos, especialmente cuando es confusa o tumultuaria. 3. f. Riña o pendencia en que hay heridos o muertes.
sementara	 1. tr. p. us. Sembrar un terreno.
serpollo	1. m. Cada una de las ramas nuevas que brotan al pie de un árbol o en la parte por donde se le ha podado. 2. m. renuevo (‖ vástago de una planta).
sesquipedalismo	Versión electrónica 23.4 del «Diccionario de la lengua española», obra lexicográfica académica por excelencia.
sicofante	 1. m. sicofanta.
sigüí	Versión electrónica 23.4 del «Diccionario de la lengua española», obra lexicográfica académica por excelencia.
sileno	 1. m. Ser de la mitología grecorromana, de aspecto semejante al del sátiro, pero con orejas, patas y cola de caballo.
sindiós	Versión electrónica 23.4 del «Diccionario de la lengua española», obra lexicográfica académica por excelencia.
sinecura	 1. f. Empleo o cargo retribuido que ocasiona poco o ningún trabajo.
sinestésicas	Versión electrónica 23.4 del «Diccionario de la lengua española», obra lexicográfica académica por excelencia.
sino	1. m. hado. 2. m. desus. pero (‖ defecto). 3. m. desus. Cosa que evoca en el entendimiento la idea de otra. pasar el sino 1. loc. verb. coloq. And. Pasar grandes trabajos o disgustos.
solivianta	1. tr. Mover el ánimo de alguien para inducirle a adoptar alguna actitud rebelde u hostil. U. t. c. prnl. 2. tr. Inquietar o alterar a alguien.
soliviantados	Entradas que contienen la forma «soliviantados» | Diccionario de la lengua española | RAE - ASALE
soliviantan	1. tr. Mover el ánimo de alguien para inducirle a adoptar alguna actitud rebelde u hostil. U. t. c. prnl. 2. tr. Inquietar o alterar a alguien.
somantas	 1. f. coloq. Tunda, zurra.
soplagaitas	 1. m. y f. coloq. Persona tonta o estúpida.
soplapollas	 1. m. y f. malson. Persona tonta o estúpida.
soslayo	1. adj. Soslayado, oblicuo. al soslayo 1. loc. adv. oblicuamente. de soslayo 1. loc. adv. oblicuamente. 2. loc. adv. De costado y perfilando bien el cuerpo para pasar por alguna estrechura.
sotol	1. m. Méx. Planta liliácea de la que se obtiene una bebida alcohólica. 2. m. Méx. Licor que se obtiene del sotol, y, por ext., el de la caña de azúcar o el del maíz.
suavizantes	 1. adj. Que suaviza. 2. m. Líquido usado para suavizar y perfumar la colada. 3. m. acondicionador (‖ cosmético).
supina	 Que se da en alto grado. Estupidez supina.
sílfide	 1. f. Según los cabalistas, ser fantástico o espíritu elemental del aire. 2. f. coloq. Mujer muy delgada y esbelta.
tabarras	 1. f. coloq. Esp. Molestia causada por algo pesado e insistente. Dar la tabarra.
tagarnina	 1. f. cardillo1. 2. f. fest. coloq. Cigarro puro muy malo.
taifa	1. f. Cada uno de los reinos en que se dividió la España musulmana al disolverse el califato cordobés. Reyes de taifa. 2. f. Bando, facción.
tamo	1. m. Pelusa que se desprende del lino, del algodón o de la lana. 2. m. Polvo o paja muy menuda de varias semillas trilladas, como el trigo, el lino, etc.
taperujamos	 1. prnl. coloq. Arrebujarse o taparse de cualquier modo con la ropa.
tebeo	1. adj. desus. tebano. Apl. a pers., era u. t. c. s. 1. m. Publicación infantil o juvenil cuyo asunto se desarrolla en series de dibujos. 2. m. Serie de aventuras contada en forma de historietas gráficas.
tebeos	Entradas que contienen la forma «tebeos» | Diccionario de la lengua española | RAE - ASALE
tegumento	1. m. Biol. Órgano que sirve de protección externa al cuerpo humano y de los animales, con varias capas y anejos como glándulas, escamas, pelo y plumas.
tentetieso	1. m. Muñeco de materia ligera, o hueco, que lleva un contrapeso en la base, y que, movido en cualquier dirección, vuelve siempre a quedar derecho.
termolábil	 1. adj. Que se altera fácilmente por la acción del calor.
tinerfeño	1. adj. Natural de Tenerife, isla del archipiélago canario, en España. U. t. c. s. 2. adj. Perteneciente o relativo a Tenerife o a los tinerfeños.
tisis	 1. f. Tuberculosis pulmonar. 2. f. Med. Enfermedad en que hay consunción gradual y lenta, fiebre y ulceración en algún órgano.
titis	 1. m. y f. coloq. Persona joven, especialmente una mujer. 2. m. y f. coloq. U. como apelativo, especialmente entre jóvenes.
tomar	1. tr. Coger o asir con la mano algo. 2. tr. Coger, aunque no sea con la mano. Tomar tinta con la pluma. Tomar agua de la fuente. 3. tr. Recibir algo y hacerse cargo de ello.
tontolaba	Versión electrónica 23.4 del «Diccionario de la lengua española», obra lexicográfica académica por excelencia.
torce	 1. f. Cada una de las vueltas que da alrededor del cuello una cadena o un collar. 2. f. p. us. collar.
tordo	 Que tiene el pelo mezclado de negro y blanco, como el plumaje del tordo. U. t. c. s. 2. m. y f. Pájaro de unos 24 cm de largo, cuerpo grueso, pico delgado y negro, lomo gris aceitunado, vientre blanco amarillento con manchas pardas redondas o triangulares y las cobijas de color amarillo rojizo. Es común en España y se alimenta de insectos y de frutos, principalmente de aceitunas. U. en m. ref. a la especie.
torrefacto	 Tostado con algo de azúcar.
torrezno	 1. m. Pedazo de tocino frito o para freír.
trabucaires	 1. adj. Valentón, osado. 2. m. Antiguo faccioso catalán armado de trabuco.
trampantojos	 1. m. coloq. Trampa o ilusión con que se engaña a alguien haciéndole ver lo que no es.
transigir	1. intr. Consentir en parte con lo que no se cree justo, razonable o verdadero, a fin de acabar con una diferencia. U. t. c. tr. 2. tr. Ajustar algún punto dudoso o litigioso, conviniendo las partes voluntariamente en algún medio que componga y parta la diferencia de la disputa.
trasunto	 1. m. Copia escrita de un original. 2. m. Imitación exacta, imagen o representación de algo.
trilero	 1. m. y f. Persona que dirige el juego del trile.
tráfago	1. m. Conjunto de negocios, ocupaciones o faenas que ocasionan mucha fatiga o molestia. Desbordado por el tráfago de sus ocupaciones. 2. m. tráfico.
tránsfugas	1. m. y f. Persona que pasa de una ideología o colectividad a otra. 2. m. y f. Persona que con un cargo público no abandona este al separarse del partido que lo presentó como candidato.
tunante	 1. adj. Pícaro, bribón, taimado. U. t. c. s. 2. adj. desus. Que tuna. Era u. t. c. s.
táper	 1. m. Recipiente con cierre hermético, que se usa para guardar o llevar alimentos.
tártaro	1. m. Tartrato ácido de potasio que forma una costra cristalina en el fondo y paredes de la vasija donde fermenta el mosto. 2. m. Sarro de los dientes.
títere	1. m. Muñeco que se mueve por medio de hilos u otro procedimiento. 2. m. Persona que se deja manejar. 3. m. Preocupación de escaso fundamento.
ubérrimo	 1. adj. Muy abundante y fértil.
ultracrepidario	Versión electrónica 23.4 del «Diccionario de la lengua española», obra lexicográfica académica por excelencia.
urdido	1. tr. Preparar los hilos en la urdidera para pasarlos al telar. 2. tr. Maquinar y disponer cautelosamente algo contra alguien, o para la consecución de algún designio.
urdimbre	1. f. Estambre o pie después de urdido. 2. f. Conjunto de hilos que se colocan en el telar paralelamente unos a otros para formar una tela.
uxoricida	 1. m. y f. Persona que mata a su mujer. U. t. c. adj.
vacaburrez	Versión electrónica 23.4 del «Diccionario de la lengua española», obra lexicográfica académica por excelencia.
valedor	 1. m. y f. Persona que vale (‖ ampara).
vera	1. f. orilla1. 2. f. Sal. y Zam. Faja pintada en la parte inferior de una pared, friso. a la vera 1. loc. adv. a la orilla. 2. loc. adv. Al lado próximo.
verecundia	 1. f. vergüenza.
verga	1. f. pene. 2. f. Arco de acero de la ballesta. 3. f. vara (‖ palo largo y delgado). 4. f. Tira de plomo con ranuras en los cantos, que sirve para asegurar los vidrios de las ventanas.
vergajazo	 1. m. Golpe dado con un vergajo.
vergajo	 1. m. Verga del toro, que después de cortada, seca y retorcida, se usa como látigo.
verja	 1. f. Enrejado que sirve de puerta, ventana o, especialmente, cerca.
vestidos	Entradas que contienen la forma «vestidos» | Diccionario de la lengua española | RAE - ASALE
vida	1. f. Fuerza o actividad esencial mediante la que obra el ser que la posee. 2. f. Energía de los seres orgánicos. 3. f. Hecho de estar vivo. Le debe la vida a un medicamento.
vitualla	1. f. Conjunto de cosas necesarias para la comida, especialmente en los ejércitos. U. m. en pl. 2. f. coloq. Abundancia de comida, y sobre todo de menestra o verdura.
vituallas	Entradas que contienen la forma «vituallas» | Diccionario de la lengua española | RAE - ASALE
voluta	1. f. Figura en forma de espiral. Voluta de humo. 2. f. Arq. Adorno en forma de espiral o caracol, que se coloca en los capiteles de los órdenes jónico y compuesto.
vombátido	Versión electrónica 23.4 del «Diccionario de la lengua española», obra lexicográfica académica por excelencia.
yerma	 1. adj. inhabitado. Apl. a lugar, u. t. c. s. m. 2. adj. No cultivado. Apl. a terreno, u. t. c. s. m. padre del yermo
zahorí	1. m. y f. Persona a quien se atribuye la facultad de descubrir lo que está oculto, especialmente manantiales subterráneos. 2. m. y f. Persona perspicaz y escudriñadora, que descubre o adivina fácilmente lo que otras personas piensan o sienten.
zalamerías	 1. f. Demostración de cariño afectada y empalagosa.
zancajear	 1. intr. Andar mucho de una parte a otra, por lo común aceleradamente.
zarpa	1. f. Mano de ciertos animales cuyos dedos no se mueven con independencia unos de otros, como en el león y el tigre. 2. f. Lodo o barro que se queda en la parte baja de la ropa.
zarramplín	 1. m. Pelagatos, pobre diablo. 2. m. coloq. Hombre chapucero y de poca habilidad en una profesión u oficio.
zonzo	 1. adj. Soso, insulso, insípido. Apl. a pers., u. t. c. s. 2. adj. Tonto, simple, mentecato. ave zonza
zorronglona	 Que ejecuta pesadamente, de mala gana y murmurando o refunfuñando, lo que le mandan. U. t. c. s.
zote	 1. adj. Ignorante, torpe y muy tardo en aprender. U. t. c. s.
zumbón	 Que frecuentemente anda burlándose, o tiene el genio festivo y poco serio. U. t. c. s. 2. m. cencerro zumbón.
¡Donosa	Versión electrónica 23.4 del «Diccionario de la lengua española», obra lexicográfica académica por excelencia.
¡Eres	Versión electrónica 23.4 del «Diccionario de la lengua española», obra lexicográfica académica por excelencia.
Ábside	1. m. Arq. En una iglesia, parte abovedada y por lo común semicircular que sobresale en la fachada posterior, donde normalmente se instalaban el altar y el presbiterio.
íncubo	 Que, según la opinión vulgar, bajo apariencia de varón tenía trato carnal con una mujer. U. t. c. s. m.
índole	 1. f. Condición e inclinación natural propia de cada persona. 2. f. Naturaleza, calidad y condición de las cosas.
óbelo	 1. m. obelisco.
óbolo	1. m. Pequeña cantidad con la que se contribuye para un fin determinado. 2. m. Moneda de plata de la antigua Grecia, que era la sexta parte de la dracma.
órdago	1. m. En el juego del mus, envite del resto. de órdago 1. loc. adj. coloq. extraordinario (‖ fuera de lo común). Borrachera, calor de órdago.
Acantalear	 1. intr. impers. rur. Ar. Caer granizo grueso. 2. intr. impers. rur. Ar. Llover copiosamente.
Jarrear	Entradas que contienen la forma «Jarrear» | Diccionario de la lengua española | RAE - ASALE
Cernidillo	 1. m. Lluvia muy menuda. 2. m. Modo de andar con pasos cortos y contoneándose.
taifa	1. f. Cada uno de los reinos en que se dividió la España musulmana al disolverse el califato cordobés. Reyes de taifa. 2. f. Bando, facción.
tentetieso	1. m. Muñeco de materia ligera, o hueco, que lleva un contrapeso en la base, y que, movido en cualquier dirección, vuelve siempre a quedar derecho.
cotarro	1. m. coloq. Reunión de personas. U. con intención despect. o fest. 2. m. coloq. Conjunto de personas con determinadas características comunes. El cotarro político está alborotado.
motejar	 1. tr. Notar, censurar las acciones de alguien con motes o apodos.
jalear	1. tr. Animar con palmadas, ademanes y expresiones a los que bailan, cantan, etc. U. t. c. prnl. 2. tr. Llamar a los perros a voces para animarlos a seguir la caza.
pota	 1. f. Calamar basto.
ruín	Versión electrónica 23.4 del «Diccionario de la lengua española», obra lexicográfica académica por excelencia.
ruin	 Baja, de malas costumbres y procedimientos.
alóctono	 1. adj. Que no es originario del lugar en que se encuentra.
justipreciar	 1. tr. Apreciar o tasar algo.
grilla	1. m. y f. Insecto ortóptero saltador, de unos tres centímetros de largo, color negro rojizo, con una mancha amarilla en el arranque de las alas, cabeza redonda y ojos muy prominentes, cuyo macho sacude y roza con tal fuerza los élitros, que produce un sonido agudo y monótono. U. en m. ref. a la especie.
español	1. adj. Natural de España, país de Europa. U. t. c. s. 2. adj. Perteneciente o relativo a España o a los españoles. 3. adj. Perteneciente o relativo al español (‖ lengua). Léxico español.
bulo	 1. m. Noticia falsa propalada con algún fin.
dextrógiro	 Que desvía a la derecha el plano de la luz polarizada cuando se mira hacia la fuente. U. t. c. s. m.
levógiro	 Que desvía a la izquierda el plano de la luz polarizada cuando se mira hacia la fuente. U. t. c. s. m.
sinistrorso	 1. adj. Bot. levógiro (‖ que gira en sentido contrario a las agujas del reloj).
cucucho	 a cucucho 1. loc. adv. El Salv. a cuestas (‖ sobre los hombros o las espaldas).
camasquince	Versión electrónica 23.4 del «Diccionario de la lengua española», obra lexicográfica académica por excelencia.
maniatado	 1. tr. Atar las manos.
zampabollos	 1. m. y f. coloq. Persona que come con exceso y con ansia.
pelusa	1. f. Pelo muy tenue de algunas frutas. 2. f. Pelo menudo que con el uso se desprende de las telas. 3. f. Vello tenue que aparece en la cara de las personas y en el cuerpo de los polluelos de algunas aves.
cacharro	1. m. Vasija, recipiente. 2. m. Trozo de vasija rota. U. m. en pl. Tropezó y la taza se hizo cacharros. 3. m. coloq. Aparato, artefacto. 4. m. coloq. Aparato viejo o que funciona mal.
virus	1. m. Organismo de estructura muy sencilla, compuesto de proteínas y ácidos nucleicos, y capaz de reproducirse solo en el seno de células vivas específicas, utilizando su metabolismo.
nucleico	 ácido nucleico
ácido	1. adj. Que tiene sabor agrio o de vinagre. 2. adj. Que tiene las características o propiedades de un ácido. 3. adj. Áspero, desabrido. 4. adj. mordaz (‖ propenso a murmurar).
ensoberbecido	 Agitarse, alterarse, encresparse.
sacro	1. adj. sagrado. 2. adj. Anat. Perteneciente o relativo a la región en que está situado el hueso sacro, en la parte posterior de la pelvis. Nervios sacros.
profano	1. adj. Que no es sagrado ni sirve a usos sagrados, sino puramente secular. 2. adj. Que no demuestra el respeto debido a las cosas sagradas.
plutarco	Versión electrónica 23.4 del «Diccionario de la lengua española», obra lexicográfica académica por excelencia.
trompeta	1. f. Instrumento musical de viento, consistente en un tubo largo de metal que va ensanchándose desde la boquilla al pabellón y produce diversidad de sonidos según la fuerza con que la boca impele el aire.
impele	 1. tr. impulsar.
sitis	Versión electrónica 23.4 del «Diccionario de la lengua española», obra lexicográfica académica por excelencia.
pancreas	Versión electrónica 23.4 del «Diccionario de la lengua española», obra lexicográfica académica por excelencia.
cirrosis	1. f. Med. Enfermedad caracterizada por una lesión que se desarrolla en las vísceras, especialmente en el hígado, y consiste en la induración de los elementos conjuntivos y atrofia de los demás.
induración	 1. f. Med. Acción y efecto de endurecer.
baritono	Versión electrónica 23.4 del «Diccionario de la lengua española», obra lexicográfica académica por excelencia.
barítono	 1. m. Mús. Voz media entre la de tenor y la de bajo. 2. m. Mús. Hombre que tiene voz de barítono.
tenor	1. m. Constitución u orden firme y estable de algo. 2. m. Contenido literal de un escrito u oración. a este tenor 1. loc. adv. Por el mismo estilo.
arrequive	1. m. Labor o guarnición que se ponía en el borde del vestido, como hoy el ribete o galoncillo que se echa al canto. 2. m. pl. coloq. Adornos o atavíos. Juana iba con todos sus arrequives.
luz	1. f. Agente físico que hace visibles los objetos. 2. f. Claridad que irradian los cuerpos en combustión, ignición o incandescencia. 3. f. corriente eléctrica. El recibo de la luz.
limpia	1. f. Acción y efecto de limpiar. Hice una limpia en el trastero. 2. f. C. Rica y Cuba. Acción de limpiar el terreno para sembrar. 3. f. C. Rica. Época en que se limpia el terreno para sembrar.
virgen	1. m. y f. Persona que no ha tenido relaciones sexuales. U. t. c. adj. 2. m. y f. Persona que, conservando su castidad, la ha consagrado a una divinidad.
bogavante	1. m. Primer remero de cada banco de la galera. 2. m. Lugar en que se sentaba el bogavante. 1. m. Crustáceo marino, decápodo, de color vivo, muy semejante por su forma y tamaño a la langosta, de la cual se distingue principalmente porque las patas del primer par terminan en pinzas muy grandes y robustas.
PENÍNSULA	1. f. Tierra cercada por el agua, y que solo por una parte relativamente estrecha está unida y tiene comunicación con otra tierra de extensión mayor.
tía	 no hay tu tía V. tutía. V. tío.
vulgar	 Que pertenece al vulgo. Era u. t. c. s. 3. adj. Que es impropio de personas cultas o educadas.
vulgo	1. m. Común o conjunto de la gente popular. 2. m. Conjunto de las personas que en cada materia no conocen más que la parte superficial. 3. m. germ. mancebía (‖ casa de prostitución).
mancebía	1. f. Casa de prostitución. 2. f. p. us. amancebamiento. 3. f. desus. juventud (‖ período de la vida). 4. f. desus. Acción atrevida o transgresora del orden, propia de los jóvenes.
amancebamiento	 1. m. p. us. Acción y efecto de amancebarse.
amancebarse	 1. prnl. Establecer una relación marital sin mediar vínculo de matrimonio.
Dialéctica	Entradas que contienen la forma «Dialéctica» | Diccionario de la lengua española | RAE - ASALE
rama	1. f. Cada una de las partes que nacen del tronco o tallo principal de la planta y en las cuales brotan por lo común las hojas, las flores y los frutos.
dialéctico	1. adj. Perteneciente o relativo a la dialéctica. 2. m. y f. Persona con especial capacidad para debatir y argumentar. 3. f. Arte de dialogar, argumentar y discutir.
Herrejón	Versión electrónica 23.4 del «Diccionario de la lengua española», obra lexicográfica académica por excelencia.
peredo	Versión electrónica 23.4 del «Diccionario de la lengua española», obra lexicográfica académica por excelencia.
lópez	esos son otros López 1. expr. coloq. U. para dar a entender que algo no tiene relación alguna con otra cosa, aunque parezca de su misma especie.
engorronado	Versión electrónica 23.4 del «Diccionario de la lengua española», obra lexicográfica académica por excelencia.
engorronarse	 1. prnl. rur. Ar. Vivir completamente retirado y casi como escondido.
Zorronglón	 Que ejecuta pesadamente, de mala gana y murmurando o refunfuñando, lo que le mandan. U. t. c. s.
lantano	1. m. Elemento químico metálico, de núm. atóm. 57, que encabeza el grupo de los lantánidos, de color blanco grisáceo, maleable y combustible, escaso en la corteza terrestre, donde se encuentra disperso en algunos minerales, usado en metalurgia y en cerámica. (Símb. La).
sancirole	 1. m. Bobalicón, papanatas.
regalía	1. f. Preeminencia, prerrogativa o excepción particular y privativa que en virtud de suprema potestad ejerce un soberano en su reino o Estado; p. ej., el batir moneda.
vibrisas	1. f. pl. Bot. Pelos sensoriales de las plantas insectívoras, como los de la dionea o atrapamoscas. 2. f. pl. Zool. Pelos rígidos más o menos largos que actúan como receptores táctiles, propios de gran número de mamíferos y que aparecen, aislados o formando grupos, en distintas partes de la cabeza y de los miembros, especialmente sobre los labios; p. ej., los bigotes del gato.
fraternidad	1. f. Amistad o afecto entre hermanos o entre quienes se tratan como tales. 2. f. hermandad. 3. f. En los Estados Unidos de América, asociación estudiantil, por lo general masculina, que habitualmente cuenta con una residencia especial.
truculento	 1. adj. Que sobrecoge o asusta por su morbosidad, exagerada crueldad o dramatismo.
impelía	 1. tr. impulsar.
impulsar	 1. tr. Dar empuje para producir movimiento. 2. tr. Incitar, estimular.
alféizar	1. m. Vuelta o derrame que hace la pared en el corte de una puerta o ventana, tanto por la parte de adentro como por la de afuera, dejando al descubierto el grueso del muro.
alféizares	1. m. Vuelta o derrame que hace la pared en el corte de una puerta o ventana, tanto por la parte de adentro como por la de afuera, dejando al descubierto el grueso del muro.
kapo	Versión electrónica 23.4 del «Diccionario de la lengua española», obra lexicográfica académica por excelencia.
lager	Versión electrónica 23.4 del «Diccionario de la lengua española», obra lexicográfica académica por excelencia.
logomaquia	 1. f. Discusión en que se atiende a las palabras y no al fondo del asunto.
bloste	Versión electrónica 23.4 del «Diccionario de la lengua española», obra lexicográfica académica por excelencia.
panafresco	Versión electrónica 23.4 del «Diccionario de la lengua española», obra lexicográfica académica por excelencia.
oxímetro	Versión electrónica 23.4 del «Diccionario de la lengua española», obra lexicográfica académica por excelencia.
versolibrista	Versión electrónica 23.4 del «Diccionario de la lengua española», obra lexicográfica académica por excelencia.
tirillas	 1. m. y f. coloq. Persona delgada y endeble. U. t. c. adj.
pibil	 Que se envuelve en hojas de plátano y se cocina bajo tierra, en barbacoa u horneado.
barbacoa	1. f. Parrilla usada para asar al aire libre carne o pescado. 2. f. Conjunto de alimentos preparados en una barbacoa. Comerse una barbacoa de pescado.
papanatas	 1. m. y f. coloq. Persona simple y crédula o demasiado cándida y fácil de engañar.
mofletes	 1. m. coloq. Carrillo demasiado grueso y carnoso, que parece que está hinchado.
descomulgar	 1. tr. excomulgar.
excomulgar	1. tr. Rel. En el catolicismo, apartar a alguien de la comunión de los fieles y del uso de los sacramentos. 2. tr. Declarar a alguien fuera de la comunión o trato con otra u otras personas.
Catotas	Versión electrónica 23.4 del «Diccionario de la lengua española», obra lexicográfica académica por excelencia.
Catota	Versión electrónica 23.4 del «Diccionario de la lengua española», obra lexicográfica académica por excelencia.
raigambre	1. f. Conjunto de raíces de los vegetales, unidas y trabadas entre sí. 2. f. Conjunto de antecedentes, intereses, hábitos o afectos que hacen firme y estable algo o que ligan a alguien a un sitio.
hediondez	 1. f. Cosa hedionda. 2. f. Mal olor.
aforismo	 1. m. Máxima o sentencia que se propone como pauta en alguna ciencia o arte.
siliciarse	Versión electrónica 23.4 del «Diccionario de la lengua española», obra lexicográfica académica por excelencia.
cilisiarse	Versión electrónica 23.4 del «Diccionario de la lengua española», obra lexicográfica académica por excelencia.
manceria	Versión electrónica 23.4 del «Diccionario de la lengua española», obra lexicográfica académica por excelencia.
manseria	Versión electrónica 23.4 del «Diccionario de la lengua española», obra lexicográfica académica por excelencia.
mancerina	 1. f. Plato con una abrazadera circular en el centro, donde se coloca y sujeta la jícara en que se sirve el chocolate.
casporco	Versión electrónica 23.4 del «Diccionario de la lengua española», obra lexicográfica académica por excelencia.
gaspurgo	Versión electrónica 23.4 del «Diccionario de la lengua española», obra lexicográfica académica por excelencia.
andaluz	1. adj. Natural de Andalucía, comunidad autónoma de España. U. t. c. s. 2. adj. Perteneciente o relativo a Andalucía o a los andaluces. 3. adj. Perteneciente o relativo al andaluz (‖ variedad). Léxico andaluz.
andalucía	Versión electrónica 23.4 del «Diccionario de la lengua española», obra lexicográfica académica por excelencia.
endécada	 1. f. Período de once años.
dehesa	1. f. Tierra generalmente acotada y arbolada, por lo común destinada a pastos. dehesa carneril 1. f. dehesa en que pastan carneros. dehesa potril
arramblar	 Dejar cubierto de arena el suelo por donde pasa, en tiempo de avenidas. 2. tr. Arrastrarlo todo, llevándoselo con violencia.
aporcar	1. tr. Cubrir con tierra ciertas plantas, como el apio, el cardo, la escarola y otras hortalizas, para que se pongan más tiernas y blancas.
abajar	 1. tr. bajar. U. t. c. intr. y c. prnl. 2. tr. Veter. Cortar mucho del casco de las caballerías.
marasmo	 1. m. Suspensión, paralización, inmovilidad, en lo moral o en lo físico. 2. m. Med. Extremado enflaquecimiento del cuerpo humano.
idem	1. pron. El mismo, lo mismo. U. generalmente abreviado en las citas para representar el nombre del autor últimamente mencionado, y en las cuentas y listas, para denotar diferentes partidas de una sola especie.
regojo	 1. m. p. us. Muchacho pequeño. 2. m. desus. Pedazo o porción de pan que queda de sobra en la mesa después de haber comido.
zasca	1. m. coloq. Esp. Respuesta cortante, chasco, escarmiento. 2. interj. coloq. Esp. U. para imitar el sonido de un golpe o expresar el efecto de un movimiento brusco. Me dio otro golpe, ¡zasca! Se volvió y, ¡zasca!, pegó un salto.
filólogo	 1. m. y f. Persona versada en filología.
filología	1. f. Ciencia que estudia las culturas tal como se manifiestan en su lengua y en su literatura, principalmente a través de los textos escritos.
festinar	 1. tr. Ec. malversar. 2. tr. desus. Apresurar, precipitar, activar. U. en Cuba, Hond., Méx., Perú, R. Dom. y Ven.
tilín	1. m. Sonido de la campanilla. en un tilín 1. loc. adv. coloq. Chile, Col., Cuba y Ven. en un tris. hacer tilín 1. loc. verb. coloq. Caer en gracia, lograr aprobación, inspirar afecto.
pavesa	1. f. Partecilla ligera que salta de una materia inflamada y acaba por convertirse en ceniza. estar alguien hecho una pavesa 1. loc. verb. coloq. Estar muy extenuado y débil.
AUPA	Versión electrónica 23.4 del «Diccionario de la lengua española», obra lexicográfica académica por excelencia.
Bembé	 1. m. Cuba. Ritual de origen africano caracterizado por toque de tambores.
Bicorne	 1. adj. poét. De dos cuernos o dos puntas.
Carnestolendas	 1. f. pl. carnaval (‖ días anteriores a la Cuaresma). 2. f. pl. carnaval (‖ fiesta popular).
Catotas	Versión electrónica 23.4 del «Diccionario de la lengua española», obra lexicográfica académica por excelencia.
Colodrillo	 1. m. Parte posterior de la cabeza.
Enclisis	 1. f. Gram. Unión prosódica de una o más palabras inacentuadas con la tónica que las precede.
Farruca	Entradas que contienen la forma «Farruca» | Diccionario de la lengua española | RAE - ASALE
Gregüescos	 1. m. Calzón muy ancho que se usaba en los siglos XVI y XVII. U. m. en pl. con el mismo significado que en sing.
Hemencioso	 1. adj. desus. Vehemente, activo, eficaz.
Incuria	 1. f. Poco cuidado, negligencia.
Mecanuscrito	 1. adj. Escrito a máquina o con computadora. U. t. c. s. m.
Odisea	1. f. Viaje largo, en el que abundan las aventuras adversas y favorables al viajero. 2. f. Sucesión de peripecias, por lo general desagradables, que le ocurren a alguien.
Oxte	1. interj. p. us. U. para rechazar a alguien o algo que molesta, ofende o daña. no decir oxte ni moxte  1. loc. verb. coloq. No decir nada.
Proemio	 1. m. Prólogo, discurso antepuesto al cuerpo de un libro.
Pujo	1. m. Gana continua o frecuente de defecar o de orinar, con gran dificultad de lograrlo y acompañada de dolores. 2. m. Gana violenta de prorrumpir en un afecto exterior, como la risa o el llanto.
QUERREQUERRE	1. m. Ven. Pájaro de la familia de los córvidos, de aproximadamente 30 cm de longitud, de lomo y alas verdes, vientre amarillo, cola verde por encima, coronilla azul con una pequeña cresta eréctil, y garganta y mejillas de color negro brillante, que habita en bandadas en regiones de hasta 1000 m sobre el nivel del mar y emite un canto ruidoso.
Roma	a Roma por todo 1. expr. coloq. U. para dar a entender que se acomete con ánimo y confianza cualquier empresa, por ardua que sea. mover, remover, o revolver, Roma con Santiago
Satanelo	Versión electrónica 23.4 del «Diccionario de la lengua española», obra lexicográfica académica por excelencia.
Sentir	Entradas que contienen la forma «Sentir» | Diccionario de la lengua española | RAE - ASALE
Sentir	Entradas que contienen la forma «Sentir» | Diccionario de la lengua española | RAE - ASALE
Taruca	Versión electrónica 23.4 del «Diccionario de la lengua española», obra lexicográfica académica por excelencia.
Wonbat	Versión electrónica 23.4 del «Diccionario de la lengua española», obra lexicográfica académica por excelencia.
Xilófago	 Que roe la madera. U. t. c. s. m.
Xilófono	1. m. Instrumento musical de percusión formado por láminas generalmente de madera, ordenadas horizontalmente según su tamaño y sonido, que se hacen sonar golpeándolas con dos baquetas.
abuhado	 1. adj. Hinchado o abotagado. 2. adj. Pálido, de mal color.
achoclonar	 1. tr. coloq. Chile. Agrupar en forma desordenada. U. m. c. prnl.
aciago	 1. adj. Infausto, infeliz, desgraciado, de mal agüero. 2. m. desus. Azar, desgracia.
agibílibus	 1. m. coloq. Habilidad, ingenio, a veces pícaro, para desenvolverse en la vida. 2. m. coloq. Persona que tiene agibílibus.
ahitar	1. tr. Señalar los lindes de un terreno con hitos (‖ mojones). 1. tr. Causar ahíto (‖ indigestión). U. t. c. intr. 2. prnl. Comer hasta padecer indigestión o empacho.
albarda	1. f. Pieza principal del aparejo de las caballerías de carga, que se compone de dos a manera de almohadas rellenas, generalmente de paja, y unidas por la parte que cae sobre el lomo del animal.
alebrarse	 1. prnl. Echarse en el suelo pegándose contra él. 2. prnl. acobardarse.
aovar	 Poner huevos.
apoteosis	1. f. Ensalzamiento de una persona con grandes honores o alabanzas. 2. f. Manifestación de gran entusiasmo en algún momento de una celebración o acto colectivo.
arrellanarse	 1. prnl. Ensancharse y extenderse en el asiento con toda comodidad. 2. prnl. Encontrarse a gusto en un lugar o empleo.
atraquina	Versión electrónica 23.4 del «Diccionario de la lengua española», obra lexicográfica académica por excelencia.
atroz	1. adj. Fiero, cruel, inhumano. 2. adj. Enorme, grave. 3. adj. terrible (‖ muy grande). Hambre atroz. 4. adj. Pésimo, muy desagradable. Aquel fue un día atroz.
llamarada	1. f. Llama que se levanta del fuego y se apaga pronto. 2. f. Encendimiento repentino y momentáneo del rostro. 3. f. Movimiento repentino del ánimo y de poca duración.
atusaba	 Igualar con tijeras las murtas y otras plantas. 3. tr. Alisar el pelo, especialmente pasando por él la mano o el peine mojados.
bascongado	Versión electrónica 23.4 del «Diccionario de la lengua española», obra lexicográfica académica por excelencia.
bombástico	 Que habla o escribe con lenguaje bombástico.
boñiga	 1. f. Excremento de algunos animales, especialmente del ganado vacuno y del caballar.
calamocano	 Que está algo embriagada. 2. adj. coloq. chocho (‖ que chochea).
carbunco	1. m. Med. y Veter. Enfermedad contagiosa, frecuente y mortífera en el ganado lanar, vacuno, cabrío y a veces en el caballar, que es transmisible al ser humano, en el que se denomina ántrax maligno, y está causada por una bacteria específica.
cayado	1. m. Palo o bastón corvo por la parte superior, especialmente el de los pastores para prender y retener las reses. 2. m. Báculo pastoral de los obispos.
cetrería	1. f. Arte de criar, domesticar, enseñar y curar a los halcones y demás aves que sirven para la caza de volatería. 2. f. Caza menor que se hace con halcones, azores y otras aves.
chachipiruli	Versión electrónica 23.4 del «Diccionario de la lengua española», obra lexicográfica académica por excelencia.
chale	 1. m. y f. Méx. Persona, residente en México, originaria de China, descendiente de chinos o con rasgos orientales.
chapodar	 1. tr. Cortar ramas de los árboles, aclarándolos, a fin de que no se envicien. 2. tr. cercenar.
chiribitas	1. f. chispa (‖ partícula encendida). U. m. en pl. 2. f. margarita (‖ planta). 3. f. Cuba. Pez acantopterigio, propio de los mares de las Antillas, con dientes en el borde de las mandíbulas, y cuyas aletas dorsal y anal están cubiertas de escamas.
cimborrio	1. m. Arq. Cuerpo cilíndrico que sirve de base a la cúpula y descansa inmediatamente sobre los arcos torales. 2. m. Arq. cúpula (‖ bóveda).
claque	1. f. Grupo de personas que asisten a un espectáculo con el fin de aplaudir en momentos señalados. La claque. 2. f. Grupo de personas que aplauden, defienden o alaban las acciones de otra buscando algún provecho.
coracero	 1. m. Soldado de caballería armado de coraza. 2. m. coloq. p. us. Cigarro puro de tabaco muy fuerte y de mala calidad.
criptomnesia	Versión electrónica 23.4 del «Diccionario de la lengua española», obra lexicográfica académica por excelencia.
cumplemés	 1. m. Día en que se cumple un mes de algún hecho, especialmente del nacimiento de un niño.
cuqui	Versión electrónica 23.4 del «Diccionario de la lengua española», obra lexicográfica académica por excelencia.
curianas	 1. f. cucaracha (‖ insecto dictióptero).
dehesa	1. f. Tierra generalmente acotada y arbolada, por lo común destinada a pastos. dehesa carneril 1. f. dehesa en que pastan carneros. dehesa potril
deslardarse	 1. prnl. desus. Enflaquecer, perder carnes.
desquijarar	 1. tr. Rasgar la boca dislocando las quijadas. U. t. c. prnl.
diglosia	1. f. Bilingüismo, en especial cuando una de las lenguas goza de prestigio o privilegios sociales o políticos superiores. 2. f. Anat. Disposición de la lengua en forma doble o bífida.
empardar	 1. tr. Arg. y Ur. Empatar, igualar, particularmente en el juego de cartas.
endécada	 1. f. Período de once años.
enlerdar	 1. tr. entorpecer (‖ dificultar).
esparadrapo	1. m. Tira de tela o de papel, una de cuyas caras está cubierta de un emplasto adherente, que se usa para sujetar los vendajes, y excepcionalmente como apósito directo o como revulsivo.
faltriquera	1. f. Bolsillo de las prendas de vestir. 2. f. Bolsa de tela que se ata a la cintura y se lleva colgando bajo la vestimenta. 3. f. cubillo (‖ aposento de los antiguos teatros de Madrid).
farruco	 Gallego o asturiano. U. t. c. s. 3. f. Palo flamenco procedente del folclore del norte de España, que se interpreta con aire de soleá.
fomes	 1. m. p. us. Causa que excita y promueve algo.
guedeja	1. f. Cabellera larga. 2. f. mechón. 3. f. Melena del león. tener algo por la guedeja 1. loc. verb. No dejar escapar la ocasión de lograrlo.
hebdómada	 1. f. p. us. semana.
hortelano	1. adj. Perteneciente o relativo a las huertas. 2. m. y f. Persona que por oficio cuida y cultiva huertas. 3. m. Pájaro de unos doce centímetros de largo desde el pico a la extremidad de la cola, con plumaje gris verdoso en la cabeza, pecho y espalda, amarillento en la garganta y de color de ceniza en las partes inferiores; cola ahorquillada con las plumas laterales blancas, uñas ganchudas y pico bastante largo. Es común en España.
hura	 1. f. Grano maligno o carbunclo que sale en la cabeza y suele ser peligroso. 2. f. Agujero pequeño o madriguera.
infraescrito	Versión electrónica 23.4 del «Diccionario de la lengua española», obra lexicográfica académica por excelencia.
jedar	 parir.
jofaina	 1. f. Vasija en forma de taza, de gran diámetro y poca profundidad, que sirve principalmente para lavarse la cara y las manos.
ladronazo	Versión electrónica 23.4 del «Diccionario de la lengua española», obra lexicográfica académica por excelencia.
lagar	1. m. Recipiente donde se pisa la uva para obtener el mosto. 2. m. Sitio donde se prensa la aceituna para sacar el aceite, o donde se machaca la manzana para obtener la sidra.
lardear	 1. tr. Untar o envolver con lardo o grasa lo que se va a asar. 2. tr. pringar (‖ echar a alguien pringue hirviendo).
lición	Versión electrónica 23.4 del «Diccionario de la lengua española», obra lexicográfica académica por excelencia.
lisonja	 1. f. Alabanza afectada para ganar la voluntad de alguien. 1. f. Heráld. losange.
mamarón	 1. m. Esp. p. us. Hombre que procura participar de fiestas y agasajos sin estar invitado.
marinovio	1. m. y f. coloq. Cuba. Persona con quien se mantiene una relación amorosa y sexual estable sin casarse. En Ven., u. solo el m. 2. m. pl. El Salv. Novios que viven como marido y mujer.
mayaba	Entradas que contienen la forma «mayaba» | Diccionario de la lengua española | RAE - ASALE
mendocino	1. adj. Natural de Mendoza, ciudad o provincia de la Argentina. U. t. c. s. 2. adj. Perteneciente o relativo a Mendoza o a los mendocinos. 1. adj. desus. Que cree en agüeros, supersticioso.
misoneísta	 1. adj. Hostil a las novedades. Apl. a pers., u. t. c. s.
moderato	1. m. Mús. Movimiento de velocidad intermedia entre la del andante y la del allegro. 2. m. Mús. Composición o parte de ella que se ha de ejecutar como moderato.
moxte	Versión electrónica 23.4 del «Diccionario de la lengua española», obra lexicográfica académica por excelencia.
ochavo	1. adj. desus. octavo (‖ que es una de las ocho partes de un todo). Era u. t. c. s. m. 2. adj. desus. octavo (‖ que ocupa en una serie el lugar número ocho).
opúsculo	 1. m. Obra científica o literaria de poca extensión.
oxte	1. interj. p. us. U. para rechazar a alguien o algo que molesta, ofende o daña. no decir oxte ni moxte  1. loc. verb. coloq. No decir nada.
oxímetro	Versión electrónica 23.4 del «Diccionario de la lengua española», obra lexicográfica académica por excelencia.
palomino	 1. m. Pollo de la paloma silvestre. 2. m. coloq. Mancha de excremento en la ropa interior.
panafresco	Versión electrónica 23.4 del «Diccionario de la lengua española», obra lexicográfica académica por excelencia.
pavesas	1. f. Partecilla ligera que salta de una materia inflamada y acaba por convertirse en ceniza. estar alguien hecho una pavesa 1. loc. verb. coloq. Estar muy extenuado y débil.
pañolón	 1. m. Pañuelo grande, de abrigo.
peer	 1. intr. Arrojar o expeler la ventosidad del vientre por el ano. U. t. c. prnl.
pejiguera	 1. f. coloq. Cosa que, sin aportar gran provecho, acarrea problemas y dificultades. hierba pejiguera
pellas	1. f. Masa que se une y aprieta, regularmente en forma redonda. 2. f. Conjunto de los tallitos de la coliflor y otras plantas semejantes, antes de florecer, que son la parte más delicada y que más se aprecia.
pisaverde	1. m. coloq. Hombre presumido y afeminado, que no conoce más ocupación que la de acicalarse, perfumarse y andar vagando todo el día en busca de galanteos.
pisiforme	 Que forma parte del carpo, y que en el ser humano es el cuarto de la primera fila. U. t. c. s. m.
polendas	Versión electrónica 23.4 del «Diccionario de la lengua española», obra lexicográfica académica por excelencia.
preboste	1. m. y f. Persona que es cabeza de una comunidad, y la preside o gobierna. 2. m. y f. Persona que en un determinado ámbito político, económico, profesional, etc., tiene una posición de gran poder e importancia.
pringue	1. m. o f. Grasa que suelta el tocino u otra cosa semejante sometida a la acción del fuego. 2. m. o f. Suciedad, grasa o porquería que se pega a la ropa o a otra cosa.
proclisis	 1. f. Gram. Unión prosódica de una o más palabras inacentuadas con la tónica que las sigue.
pundonor	 1. m. Sentimiento que impulsa a una persona a mantener su buena fama y a superarse.
regojo	 1. m. p. us. Muchacho pequeño. 2. m. desus. Pedazo o porción de pan que queda de sobra en la mesa después de haber comido.
regüeldo	 1. m. Acción y efecto de regoldar. 2. m. Cardencha imperfecta que sale en el tallo de la principal.
repantigado	 1. prnl. Arrellanarse en el asiento y extenderse para mayor comodidad.
represando	1. tr. Detener o estancar el agua corriente. U. t. c. prnl. 2. tr. Contener, reprimir. U. t. c. prnl. 3. tr. Recobrar de los enemigos la embarcación que habían apresado.
roborar	 1. tr. Dar fuerza y firmeza a algo. 2. tr. Reforzar con razones o argumentos. 3. tr. desus. Otorgar, confirmar, rubricar algo.
romo	 1. adj. Que carece de punta o filo. 2. adj. De nariz pequeña y poco puntiaguda. macho romo sabina roma
soso	 1. adj. Que no tiene sal, o tiene poca. 2. adj. Que carece de gracia y viveza. Apl. a pers., u. t. c. s.
tafetan	Versión electrónica 23.4 del «Diccionario de la lengua española», obra lexicográfica académica por excelencia.
trancahílo	 1. m. Nudo o lazo sobrepuesto para que estorbe el paso del hilo o cuerda por alguna parte.
tunante	 1. adj. Pícaro, bribón, taimado. U. t. c. s. 2. adj. desus. Que tuna. Era u. t. c. s.
tuno	1. m. And. y Col. higo de tuna. 1. adj. Pícaro, tunante. U. t. c. s. 2. m. Componente de una tuna (‖ grupo musical de estudiantes). 3. f. Grupo de estudiantes que forman un conjunto musical.
uxoricida	 1. m. y f. Persona que mata a su mujer. U. t. c. adj.
uómbats	Versión electrónica 23.4 del «Diccionario de la lengua española», obra lexicográfica académica por excelencia.
verja	 1. f. Enrejado que sirve de puerta, ventana o, especialmente, cerca.
versolibrista	Versión electrónica 23.4 del «Diccionario de la lengua española», obra lexicográfica académica por excelencia.
xilografía	 1. f. Arte de grabar en madera. 2. f. Impresión tipográfica hecha con planchas de madera grabadas.
zullenco	 1. adj. coloq. Que ventosea con frecuencia e involuntariamente o no puede contener la deposición2.
ínclito	 1. adj. Ilustre, esclarecido, afamado.
ñaque	 1. m. Compañía ambulante de teatro que estaba compuesta por dos cómicos. 2. m. p. us. Conjunto o montón de cosas inútiles y ridículas.
ñopo	Versión electrónica 23.4 del «Diccionario de la lengua española», obra lexicográfica académica por excelencia.
repera	 ser algo o alguien la repera 1. loc. verb. coloq. ser la reoca.
reoca	ser algo o alguien la reoca 1. loc. verb. coloq. Ser extraordinario por bueno, malo, absurdo o fuera de lo normal. ¡Fíjate lo que ha hecho! Este chico es la reoca. Un aumento de sueldo sería la reoca.
celesta	 1. f. Instrumento musical de teclado en que los macillos producen el sonido golpeando láminas de acero.
antipoda	Versión electrónica 23.4 del «Diccionario de la lengua española», obra lexicográfica académica por excelencia.
Idiófono	Versión electrónica 23.4 del «Diccionario de la lengua española», obra lexicográfica académica por excelencia.
armonio	 1. m. Órgano pequeño, con la forma exterior del piano, y al cual se da el aire por medio de un fuelle que se mueve con los pies.
gamelán	Versión electrónica 23.4 del «Diccionario de la lengua española», obra lexicográfica académica por excelencia.
gamelán	Versión electrónica 23.4 del «Diccionario de la lengua española», obra lexicográfica académica por excelencia.
gamelan	Versión electrónica 23.4 del «Diccionario de la lengua española», obra lexicográfica académica por excelencia.
soberbio	1. adj. Que tiene soberbia o se deja llevar de ella. U. t. c. s. 2. adj. Alto, fuerte o excesivo en las cosas inanimadas. 3. adj. Grandioso, magnífico.
soberbia	1. f. Altivez y apetito desordenado de ser preferido a otros. 2. f. Satisfacción y envanecimiento por la contemplación de las propias prendas con menosprecio de los demás.
onomatopeya	1. f. Formación de una palabra por imitación del sonido de aquello que designa. Muchas palabras como quiquiriquí han sido formadas por onomatopeya.
bubi	 De la población indígena de la isla de Bioko, antes Fernando Poo, perteneciente a la Guinea Ecuatorial. U. t. c. s.
bioko	Versión electrónica 23.4 del «Diccionario de la lengua española», obra lexicográfica académica por excelencia.
atribución	1. f. Acción de atribuir. 2. f. Cada una de las facultades o poderes que corresponden a cada parte de una organización pública o privada según las normas que las ordenen.
Sintagma	1. m. Gram. Palabra o conjunto de palabras que se articula en torno a un núcleo y que puede ejercer alguna función sintáctica. sintagma adjetival, o sintagma adjetivo
cebollo	Versión electrónica 23.4 del «Diccionario de la lengua española», obra lexicográfica académica por excelencia.
aludir	 Tener una relación, a veces velada, con alguien o con otra cosa. El nombre de cianuro alude a su color azul.
motivo	1. adj. Que mueve o tiene eficacia o virtud para mover. 2. m. Causa o razón que mueve para algo. 3. m. En arte, rasgo característico que se repite en una obra o en un conjunto de ellas.
Pasacalle	1. m. pasacalles. 2. m. Arg. y Ur. Cartel que cruza la calzada por lo alto, especialmente con anuncios de campañas políticas, gremiales, religiosas o navideñas.
Contrafagot	 1. m. Instrumento musical, análogo al fagot, cuya tesitura es una octava más grave que la de este.
fagot	1. m. Instrumento musical de viento, formado por un tubo de madera de unos siete centímetros de grueso y más de un metro de largo, con agujeros y llaves, y con una boquilla de caña puesta en un tudel.
pasacalle	1. m. pasacalles. 2. m. Arg. y Ur. Cartel que cruza la calzada por lo alto, especialmente con anuncios de campañas políticas, gremiales, religiosas o navideñas.
recital	1. m. Lectura o recitación de composiciones literarias. 2. m. Concierto compuesto de varias obras ejecutadas por un solo artista con un solo instrumento.
fuga	1. f. Acción de fugarse. 2. f. Salida accidental de gas o de líquido por un orificio o una abertura producidos en su contenedor. 3. f. Mús. Composición que consiste en la repetición de un tema y su contrapunto, con cierto artificio y por diferentes tonos.
contrapunto	1. m. Mús. Concordancia armoniosa de voces contrapuestas. 2. m. Mús. Arte de combinar, según ciertas reglas, dos o más melodías diferentes.
cuadril	1. m. Hueso que sale de la cía, de entre las dos últimas costillas, y sirve para formar el anca. 2. m. anca (‖ mitad lateral de la parte posterior de diversos animales).
cía	 1. f. desus. cea.
cea	 1. f. Hueso de la cadera.
paticure	Versión electrónica 23.4 del «Diccionario de la lengua española», obra lexicográfica académica por excelencia.
veroño	Versión electrónica 23.4 del «Diccionario de la lengua española», obra lexicográfica académica por excelencia.
esquijama	 1. m. Pijama compuesto de pantalón ajustado a los tobillos y jersey.
amigovio	 1. m. y f. coloq. Arg., Méx., Par. y Ur. Persona que mantiene con otra una relación de menor compromiso formal que un noviazgo.
birome	 1. f. Arg., Par. y Ur. bolígrafo.
pancho	1. adj. Tranquilo, inalterado. 2. adj. Satisfecho con algo. Tan pancho. 3. m. Cría del besugo. 4. m. coloq. Vientre, barriga, panza. 1. m. Arg. y Ur. perrito caliente. 2. m. Par. Emparedado de chorizo.
besugo	1. m. Pez teleósteo marino, acantopterigio, de color rosáceo, generalmente con una mancha negra en la zona de las aletas pectorales, ojos grandes y cuya carne es muy apreciada.
teleósteo	 Que tiene el esqueleto completamente osificado. U. t. c. s. m., en pl. como taxón.
acantopterigio	 Del grupo de los teleósteos, cuyas aletas, por lo menos las impares, tienen radios espinosos inarticulados; p. ej., el atún, el pez espada o el besugo. U. t. c. s. m., en pl. como taxón.
taxón	1. m. Biol. Cada una de las subdivisiones de la clasificación biológica, desde la especie, que se toma como unidad, hasta el filo o tipo de organización.
tremor	 1. m. temblor. 2. m. Comienzo del temblor.
emoticon	Versión electrónica 23.4 del «Diccionario de la lengua española», obra lexicográfica académica por excelencia.
emoticón	 1. m. emoticono. U. m. en Am.
emoticono	1. m. Símbolo formado por signos del teclado, que representa una expresión facial y se usa en los mensajes electrónicos para expresar el estado de ánimo del emisor o el tono del mensaje. U. m. en Esp.
emoji	 1. m. Pequeña imagen o icono digital que se usa en las comunicaciones electrónicas para representar una emoción, un objeto, una idea, etc.
meme	1. m. Rasgo cultural o de conducta que se transmite por imitación de persona a persona o de generación en generación. 2. m. Imagen, video o texto, por lo general distorsionado con fines caricaturescos, que se difunde principalmente a través de internet.
rodríguez	1. m. coloq. Hombre casado que se queda trabajando mientras su familia está fuera, normalmente de veraneo. Anda, está, se queda de rodríguez.
pibón	 1. m. coloq. Esp. Persona muy atractiva.
topónimo	 1. m. Ling. Nombre propio de lugar.
neologismo	 1. m. Ling. Vocablo, acepción o giro nuevo en una lengua. 2. m. Ling. Uso de neologismos.
rugbista	 1. m. y f. Chile, Ur. y Ven. Jugador de rugby.
curlin	Versión electrónica 23.4 del «Diccionario de la lengua española», obra lexicográfica académica por excelencia.
anfibología	1. f. Doble sentido, vicio de la palabra, cláusula o manera de hablar a que puede darse más de una interpretación. 2. f. Ret. Empleo voluntario de voces o cláusulas con doble sentido.
hipar	 Resollar cuando va siguiendo la caza. 3. intr. Fatigarse por el exceso de trabajo o angustiarse mucho.
resollar	 Absorber y expeler el aire por sus órganos respiratorios. 2. intr. Salir o aliviarse del trabajo o de la opresión.
himplar	 Emitir su voz natural. 2. intr. himpar.
iniquidad	 1. f. Maldad, injusticia grande.
bises	Entradas que contienen la forma «bises» | Diccionario de la lengua española | RAE - ASALE
bis	1. m. En un concierto o en un espectáculo teatral, pieza o fragmento, a veces repetición de algo interpretado antes, que se ofrece fuera de programa para responder a los aplausos o a la petición del público.
timorato	 Que se escandaliza con exageración de cosas que no le parecen conformes a la moral convencional.
cepa	1. f. Parte del tronco de cualquier árbol o planta, que está dentro de tierra y unida a las raíces. 2. f. Tronco de la vid, del cual brotan los sarmientos, y, por ext., toda la planta.
rabadilla	1. f. Punta o extremidad de la columna vertebral, formada por la última pieza del hueso sacro y por todas las del coxis. 2. f. En las aves, extremidad movible en donde están las plumas de la cola.
ramiro	 1. m. p. us. carnero (‖ macho de la oveja).
numulario	 1. m. Hombre que comercia o trata con dinero.
postero	 1. m. y f. Esp. Persona que tenía a su cargo un puesto de lotería.
lotería	1. f. lotería nacional. 2. f. Rifa o sorteo que se hace con objetos, dinero y otras cosas, con autorización pública. 3. f. lotería de cartones.
rifa	 1. f. Juego que consiste en sortear algo entre varias personas. 2. f. Contienda, pendencia, enemistad.
pendencia	1. f. Contienda, riña de palabras o de obras. 2. f. Der. Estado de un juicio que está pendiente de resolución. 3. f. desus. Cualidad de lo que está por decidir.
metonimia	1. f. Ret. Tropo que consiste en designar algo con el nombre de otra cosa tomando el efecto por la causa o viceversa, el autor por sus obras, el signo por la cosa significada, etc.; p. ej., las canas por la vejez; leer a Virgilio, por leer las obras de Virgilio; el laurel por la gloria, etc.
be	1. f. Letra b y sonido que representa. be alta, be grande, o be larga 1. f. be1. U. m. en Am. be por be 1. loc. adv. p. us. ce por be. 1. onomat. U. para imitar el balido del carnero, de la oveja y de la cabra. U. t. c. s. m.
ubérrimo	 1. adj. Muy abundante y fértil.
cascanueces	 1. m. Instrumento a modo de tenaza para partir nueces. 2. m. Pájaro conirrostro de la familia de los fringílidos.
conirrostro	 Granívoro, con el pico grueso, fuerte y cónico; p. ej., el gorrión o la alondra. U. t. c. s. m., y era u. en pl. como taxón.
Geospiza	Versión electrónica 23.4 del «Diccionario de la lengua española», obra lexicográfica académica por excelencia.
Granívoro	 Que se alimenta de granos. U. t. c. s. m.
taxón	1. m. Biol. Cada una de las subdivisiones de la clasificación biológica, desde la especie, que se toma como unidad, hasta el filo o tipo de organización.
alondra	1. f. Pájaro de 15 a 20 cm de largo, de cola ahorquillada, con cabeza y dorso de color pardo terroso y vientre blanco sucio, que anida en los campos de cereales, come insectos y granos, y abunda en toda España.
dossier	 1. m. dosier.
dosier	 1. m. Informe o expediente.
omnibus	Versión electrónica 23.4 del «Diccionario de la lengua española», obra lexicográfica académica por excelencia.
omni	Versión electrónica 23.4 del «Diccionario de la lengua española», obra lexicográfica académica por excelencia.
lívido	 1. adj. amoratado. 2. adj. Intensamente pálido.
oxígeno	1. m. Elemento químico gaseoso, de núm. atóm. 8, incoloro, inodoro, insípido y muy reactivo, presente en todos los seres vivos, esencial para la respiración y para los procesos de combustión, que forma parte del agua, de los óxidos y de casi todos los ácidos y sustancias orgánicas, y constituye casi una quinta parte del aire atmosférico en su forma molecular O2. (Símb. O).
algarabia	Versión electrónica 23.4 del «Diccionario de la lengua española», obra lexicográfica académica por excelencia.
algarabía	1. f. coloq. Gritería confusa de varias personas que hablan a un tiempo. 2. f. coloq. Lengua atropellada o ininteligible. 3. f. p. us. árabe (‖ lengua).
machuchón	Versión electrónica 23.4 del «Diccionario de la lengua española», obra lexicográfica académica por excelencia.
machucho	 Juiciosa y experimentada. Era un hombre cabal y machucho.
navidad	1. f. En el mundo cristiano, festividad anual en la que se conmemora el nacimiento de Jesucristo. 2. f. Día en que se celebra la Navidad. Hoy es Nochebuena y mañana Navidad.
caderamen	 1. m. coloq. Esp. Caderas de mujer, generalmente voluminosas.
carapacho	1. m. Caparazón de las tortugas, los cangrejos y otros animales. 2. m. coloq. Ven. esqueleto (‖ conjunto de piezas que da consistencia al cuerpo).
carcavuezo	 1. m. Hoyo profundo en la tierra.
carnazón	 1. f. Sal. Inflamación de una herida.
carne	1. f. Parte muscular del cuerpo humano o animal. 2. f. carne comestible de vaca, ternera, cerdo, carnero, etc., y muy señaladamente la que se vende para el abasto común del pueblo.
carranco	Versión electrónica 23.4 del «Diccionario de la lengua española», obra lexicográfica académica por excelencia.
carranca	 1. f. carlanca (‖ collar de puntas de hierro). 1. f. coloq. Ál. Capa de hielo en las charcas y lagunas.
catetada	Versión electrónica 23.4 del «Diccionario de la lengua española», obra lexicográfica académica por excelencia.
Revenirse	 Acedarse o avinagrarse.
Revenir	 Acedarse o avinagrarse.
esbirro	1. m. Oficial inferior de justicia que se encargaba de prender a los delincuentes. 2. m. y f. despect. Persona que ejecuta las órdenes de otra o de una autoridad, especialmente si para ello debe emplear la violencia.
Abigeato	 1. m. Arg., Bol., Chile, Col., Ec., El Salv., Hond., Méx., Nic., Pan., Par., Perú y Ur. Hurto de ganado.
Ansí	 1. adv. desus. así. U. c. rur.
Aporofobia	 1. f. cult. Fobia a las personas pobres o desfavorecidas.
Aposta	 1. adv. coloq. adrede.
Ateridos	 1. tr. Pasmar de frío. U. m. c. prnl.
BIBELOT	 1. m. Figura pequeña de adorno.
Bullebulle	 1. m. y f. coloq. Persona inquieta, entremetida y de viveza excesiva.
Bínubo	 1. adj. Casado por segunda vez. U. t. c. s.
Calderón	1. m. Cetáceo de hasta cinco metros de longitud, de cabeza voluminosa, casi globosa, y de aletas pectorales estrechas y largas. Es de color blanquecino por debajo y negro por encima, suele ir en bandadas y se alimenta principalmente de calamares.
Caluguiento	 Afectuosa en exceso.
Cansón	 Que se agota pronto.
Canto	Entradas que contienen la forma «Canto» | Diccionario de la lengua española | RAE - ASALE
Celesta	 1. f. Instrumento musical de teclado en que los macillos producen el sonido golpeando láminas de acero.
Centonar	 1. tr. p. us. Amontonar cosas o trozos de ellas sin el orden debido.
Chapaleteo	 1. m. Acción y efecto de chapaletear. 2. m. Ruido que al caer produce la lluvia.
Chischás	 1. m. Ruido de las espadas al chocar unas con otras en la lucha.
Chándal	 1. m. Ropa deportiva que consta de un pantalón y una chaqueta o jersey amplios.
DESTELLO	1. m. Acción de destellar. 2. m. Resplandor vivo y efímero, ráfaga de luz que se enciende y amengua o apaga casi instantáneamente. 3. m. vislumbre (‖ conjetura).
Efugio	 1. m. Evasión, salida, recurso para sortear una dificultad.
Envarracarse	 1. prnl. coloq. El Salv. Enamorarse ciegamente.
Etnomusicología	Versión electrónica 23.4 del «Diccionario de la lengua española», obra lexicográfica académica por excelencia.
Facta	Versión electrónica 23.4 del «Diccionario de la lengua española», obra lexicográfica académica por excelencia.
Gallete	 1. m. Úvula, garganta. beber a gallete 1. loc. verb. Beber a chorro de un botijo, bota o porrón, sin tocar el pico los labios.
Himplar	 Emitir su voz natural. 2. intr. himpar.
Junar	Versión electrónica 23.4 del «Diccionario de la lengua española», obra lexicográfica académica por excelencia.
Marinovio	1. m. y f. coloq. Cuba. Persona con quien se mantiene una relación amorosa y sexual estable sin casarse. En Ven., u. solo el m. 2. m. pl. El Salv. Novios que viven como marido y mujer.
Meteco	1. adj. despect. extranjero. U. m. c. s. 2. m. y f. En la antigua Grecia, extranjero que se establecía en Atenas y que no gozaba de los derechos de ciudadanía. U. t. c. adj.
Mor	 por mor de 1. loc. prepos. cult. Por causa de.
Opúsculos	 1. m. Obra científica o literaria de poca extensión.
Panderetas	 1. m. y f. C. Rica. Persona excesivamente religiosa.
Picio	 Excesivamente fea.
RUIBARBO	1. m. Planta herbácea, vivaz, de la familia de las poligonáceas, con hojas radicales, grandes, pecioladas, de borde dentado y sinuoso, ásperas por encima, nervudas y vellosas por debajo, y flores amarillas o verdes, pequeñas, en espigas, sobre un escapo fistuloso y esquinado. Mide de uno a dos metros de altura, tiene fruto seco, de una sola semilla triangular, y rizoma pardo por fuera, rojizo con puntos blancos en lo interior, compacto y de sabor amargo. Vive en el Asia central y la raíz se usa mucho en medicina como purgante.
Reamar	 1. tr. Amar mucho. 2. tr. desus. Corresponder al amor.
Redaño	 1. m. Anat. mesenterio. 2. m. pl. Fuerzas, bríos, valor.
Resopón	1. m. Esp. Segunda cena, más ligera, que se hace generalmente tras una fiesta o cuando pasa mucho tiempo entre la cena y la hora de acostarse.
Susurrido	 1. m. Ruido suave que hacen algunas cosas naturales.
Trasbarrás	 1. m. Ruido que produce algo al caer.
Turulo	 tonta (‖ falta de entendimiento o de razón). 2. m. Nic. cosa (‖ objeto inanimado).
Velicomen	 1. m. p. us. Copa grande para brindar.
Zopa	 Que tiene torcidos o contrahechos los pies o las manos.
ab	Versión electrónica 23.4 del «Diccionario de la lengua española», obra lexicográfica académica por excelencia.
acarnienses	Versión electrónica 23.4 del «Diccionario de la lengua española», obra lexicográfica académica por excelencia.
adarce	 1. m. Costra salina que las aguas del mar forman en los objetos que mojan.
aféresis	 1. f. Fon. Supresión de algún sonido al principio de un vocablo, como en norabuena por enhorabuena.
agible	 1. adj. Factible o hacedero.
agibílibus	 1. m. coloq. Habilidad, ingenio, a veces pícaro, para desenvolverse en la vida. 2. m. coloq. Persona que tiene agibílibus.
alacridad	 1. f. Alegría y presteza del ánimo para hacer algo.
aladares	 1. m. Mechón de pelo que cae sobre cada una de las sienes. U. m. en pl.
alipori	 1. m. coloq. vergüenza ajena.
apero	1. m. Conjunto de instrumentos y demás cosas necesarias para la labranza. U. m. en pl. 2. m. Instrumento que se emplea en la labranza. 3. m. Conjunto de animales destinados en una hacienda a las faenas agrícolas. U. m. en pl.
apócope	 1. f. Fon. Supresión de algún sonido al final de un vocablo, como en primer por primero.
arrebol	1. m. poét. Color rojo, especialmente el de las nubes iluminadas por los rayos del sol o el del rostro. 2. m. colorete (‖ cosmético). 3. m. pl. arrebolada.
autolisis	 1. f. suicidio (‖ acción de suicidarse). 2. f. Biol. Degradación de las células por sus propias enzimas.
belonefobia	Versión electrónica 23.4 del «Diccionario de la lengua española», obra lexicográfica académica por excelencia.
bojs	Versión electrónica 23.4 del «Diccionario de la lengua española», obra lexicográfica académica por excelencia.
borde	1. m. Extremo u orilla de algo. 2. m. En una vasija, orilla o labio que tiene alrededor de la boca. 3. m. Mar. borda (‖ canto superior del costado de un buque).
bucán	Versión electrónica 23.4 del «Diccionario de la lengua española», obra lexicográfica académica por excelencia.
carne	1. f. Parte muscular del cuerpo humano o animal. 2. f. carne comestible de vaca, ternera, cerdo, carnero, etc., y muy señaladamente la que se vende para el abasto común del pueblo.
cebollo	Versión electrónica 23.4 del «Diccionario de la lengua española», obra lexicográfica académica por excelencia.
cerril	 Que se obstina en una actitud o parecer, sin admitir trato ni razonamiento.
cherchar	 1. intr. Burlar, bromear.
chori	 1. m. y f. vulg. Ratero, ladronzuelo.
chulérrimos	Versión electrónica 23.4 del «Diccionario de la lengua española», obra lexicográfica académica por excelencia.
congrua	 V. congruo.
corzos	1. m. y f. Mamífero rumiante de la familia de los cérvidos, algo mayor que la cabra, rabón y de color gris rojizo, que tiene las cuernas pequeñas, verrugosas y ahorquilladas hacia la punta. U. en m. ref. a la especie.
cuspidor	Versión electrónica 23.4 del «Diccionario de la lengua española», obra lexicográfica académica por excelencia.
desternillaba	 1. prnl. Romperse las ternillas. 2. prnl. Reírse mucho, sin poder contenerse.
dintel	1. m. Pieza horizontal superior de puertas, ventanas y otros huecos, apoyada en sus extremos sobre las jambas y destinada a soportar cargas.
emético	 1. adj. Med. vomitivo (‖ que provoca el vómito). Apl. a medicamento u otro producto, u. t. c. s. m. tártaro emético
enteco	 1. adj. Enfermizo, débil, flaco.
escrucar	 1. tr. Bad. Revolver la comida en el plato.
fardar	1. tr. Surtir y abastecer a alguien, especialmente de ropa y vestidos. U. t. c. prnl. 2. intr. coloq. Esp. Presumir, jactarse, alardear. 3. intr. coloq. Esp. Servir para alardear, por lo vistoso o aparente. Ese coche farda mucho.
fetén	1. adj. Bueno, estupendo, excelente. Conocí a una chica fetén. 2. adj. coloq. Sincero, auténtico, verdadero, evidente. 3. f. coloq. La verdad. La fetén.
frangir	 1. tr. Partir o dividir algo en pedazos.
fruitivos	 1. adj. Propio para causar placer con su posesión.
gleba	1. f. Terrón que se levanta con el arado. 2. f. Tierra de cultivo. 3. f. Gente del pueblo bajo. 4. f. Hues. Terreno cubierto de césped. siervo de la gleba
gosipino	 Que tiene algodón o se parece a él.
hipar	 Resollar cuando va siguiendo la caza. 3. intr. Fatigarse por el exceso de trabajo o angustiarse mucho.
horrísona	 1. adj. Que con su sonido causa horror y espanto.
hortera	1. adj. despect. coloq. Vulgar y de mal gusto. Apl. a pers., u. t. c. s. 2. f. Escudilla o cazuela de palo. 3. m. En Madrid, apodo del mancebo de ciertas tiendas de mercader.
inconcuso	 1. adj. Firme, sin duda ni contradicción.
indinar	 1. tr. vulg. indignar. U. t. c. prnl.
lipograma	 1. m. Texto en el que, por artificio literario, se omiten deliberadamente una determinada letra o un grupo de letras.
límpido	 1. adj. poét. Limpio, terso, puro, sin mancha.
noctívago	 1. adj. poét. noctámbulo (‖ que anda vagando). Apl. a pers., u. t. c. s.
nártex	 1. m. Arq. Atrio o vestíbulo situado a la entrada de las iglesias paleocristianas y bizantinas.
paleto	 Rústica y sin habilidad para desenvolverse en ambientes urbanos. U. m. c. s.
paroxismo	1. m. Exaltación extrema de los afectos y pasiones. 2. m. Med. Exacerbación de una enfermedad. 3. m. Med. Accidente peligroso o casi mortal, en que el paciente pierde el sentido y la acción por largo tiempo.
percebe	1. m. Crustáceo cirrópodo, que tiene un caparazón compuesto de cinco piezas y un pedúnculo carnoso con el cual se adhiere a los peñascos de las costas. Se cría formando grupos y es comestible.
perífrasis	1. f. Gram. Expresión pluriverbal cuyo significado se asimila parcialmente al de una unidad léxica. La perífrasis echar una conversada se asimila al verbo conversar.
postigo	1. m. Puerta falsa que ordinariamente está colocada en sitio excusado de la casa. 2. m. Puerta que está fabricada en una pieza sin tener división ni más de una hoja, la cual se asegura con llave, cerrojo, picaporte, etc.
preuvas	Versión electrónica 23.4 del «Diccionario de la lengua española», obra lexicográfica académica por excelencia.
rabadilla	1. f. Punta o extremidad de la columna vertebral, formada por la última pieza del hueso sacro y por todas las del coxis. 2. f. En las aves, extremidad movible en donde están las plumas de la cola.
rataplán	1. onomat. U. para imitar el sonido del tambor. 2. m. En los diarios, resumen en primera página de una noticia que se publica en el interior.
rebusque	1. m. Arg., Col., Nic. y Ur. Solución ocasional e ingeniosa con que se resuelve una dificultad. 2. m. Arg., Nic., Par., Ur. y Ven. Acción y efecto de rebuscársela.
refajo	1. m. Falda exterior con vuelo, por lo general de bayeta o paño, usada por las mujeres encima de las enaguas y que forma parte de algunos trajes regionales femeninos.
resollar	 Absorber y expeler el aire por sus órganos respiratorios. 2. intr. Salir o aliviarse del trabajo o de la opresión.
retorta	1. f. Vasija con cuello largo encorvado, a propósito para diversas operaciones químicas. 2. f. Tela de hilo entrefina y de gran resistencia, con la trama y urdimbre muy retorcidas.
roma	Entradas que contienen la forma «roma» | Diccionario de la lengua española | RAE - ASALE
rugbista	 1. m. y f. Chile, Ur. y Ven. Jugador de rugby.
rusiente	 1. adj. Que se pone rojo o candente con el fuego.
sacomano	1. m. saqueo. 2. m. desus. Salteador de caminos. 3. m. desus. Soldado dedicado a forrajear. entrar, o meter, a sacomano 1. locs. verbs. saquear.
sicofanta	 1. m. Impostor, calumniador.
sisear	1. intr. Emitir repetidamente el sonido inarticulado de s y ch, por lo común para manifestar desaprobación o desagrado, o para pedir silencio. U. t. c. tr. Sisear una escena, a un orador.
solivianta	1. tr. Mover el ánimo de alguien para inducirle a adoptar alguna actitud rebelde u hostil. U. t. c. prnl. 2. tr. Inquietar o alterar a alguien.
soto	1. m. Sitio que en las riberas o vegas está poblado de árboles y arbustos. 2. m. Sitio poblado de árboles y arbustos. 3. m. Sitio poblado de malezas, matas y árboles.
termopolio	Versión electrónica 23.4 del «Diccionario de la lengua española», obra lexicográfica académica por excelencia.
titar	 Graznar para llamar a la manada.
titulitis	 1. f. despect. coloq. Valoración desmesurada de los títulos y certificados de estudios como garantía de los conocimientos de alguien.
traspillar	 1. tr. traspellar. 2. prnl. Desfallecer, extenuarse.
tutiplén	 a tutiplén 1. loc. adv. coloq. En abundancia, a porrillo.
tutía	1. f. atutía. no hay tutía   1. expr. coloq. U. para dar a entender a alguien que no debe tener esperanza de conseguir lo que desea o de evitar lo que teme.
vigoréxico	 Que padece vigorexia. Un atleta vigoréxico. U. t. c. s.
zopo	 Que tiene torcidos o contrahechos los pies o las manos.
zote	 1. adj. Ignorante, torpe y muy tardo en aprender. U. t. c. s.
zurear	 Hacer arrullos.
hiperbólico	1. adj. Perteneciente o relativo a la hipérbole. 2. adj. Que encierra o incluye una hipérbole. 3. adj. Geom. Perteneciente o relativo a la hipérbola.
hipérbola	 1. f. Geom. Lugar geométrico de los puntos del plano cuya diferencia de distancias a otros dos fijos, llamados focos, es constante.
naco	1. m. Arg., Par., P. Rico y Ur. Andullo de tabaco. 2. m. Col. Puré de papas. 3. m. coloq. Ur. susto (‖ impresión repentina). 4. m. coloq. Ur. Excremento sólido, especialmente el humano.
acecho	1. m. Acción de acechar. 2. m. p. us. Lugar desde el cual se acecha. al, de, o en, acecho 1. locs. advs. Observando y mirando a escondidas y con cuidado.
Pochoclo	Versión electrónica 23.4 del «Diccionario de la lengua española», obra lexicográfica académica por excelencia.
pururú	Versión electrónica 23.4 del «Diccionario de la lengua española», obra lexicográfica académica por excelencia.
Poroto	1. m. Arg., Bol., Chile, Ec., Par., Perú y Ur. judía (‖ planta). 2. m. Arg., Bol., Chile, Ec., Par., Perú y Ur. judía (‖ semilla). 3. m. Bol., Col., Ec., Par., Perú y Ur. Guiso que se hace con porotos.
cutre	1. adj. coloq. Tacaño, miserable. U. t. c. s. 2. adj. coloq. Pobre, descuidado, sucio o de mala calidad. Un bar, una calle, una ropa cutre.
hipoxemia	Versión electrónica 23.4 del «Diccionario de la lengua española», obra lexicográfica académica por excelencia.
carillón	1. m. Grupo de campanas en una torre, que producen un sonido armónico por estar acordadas. 2. m. Juego de tubos o planchas de acero que producen un sonido musical.
mago	1. m. y f. Persona que practica la magia. 2. m. y f. Persona singularmente capacitada para el éxito en una actividad determinada. Es un mago de las finanzas.
hispania	Versión electrónica 23.4 del «Diccionario de la lengua española», obra lexicográfica académica por excelencia.
daman	Versión electrónica 23.4 del «Diccionario de la lengua española», obra lexicográfica académica por excelencia.
polipo	Versión electrónica 23.4 del «Diccionario de la lengua española», obra lexicográfica académica por excelencia.
pólipo	1. m. Med. Tumor de estructura diversa, generalmente pediculado, que se forma y crece en las membranas mucosas de diferentes cavidades, como la nariz, el colon y, en la mujer, la vagina y la matriz.
misericordia	1. f. Virtud que inclina el ánimo a compadecerse de los sufrimientos y miserias ajenos. 2. f. Pieza en los asientos de los coros de las iglesias para descansar disimuladamente, medio sentado sobre ella, cuando se debe estar en pie.
Carámbano	1. m. Pedazo de hielo más o menos largo y puntiagudo. 2. m. Nic. carao. estar hecho, cha un carámbano 1. loc. verb. coloq. Tener mucho frío.
esmorecido	 1. adj. Ext. Aterido de frío.
aterido	 1. tr. Pasmar de frío. U. m. c. prnl.
pasmar	1. tr. Enfriar mucho o bruscamente. U. t. c. prnl. 2. tr. Helar las plantas en tanto grado, que se quedan secas y abrasadas. U. t. c. prnl.
cino	Versión electrónica 23.4 del «Diccionario de la lengua española», obra lexicográfica académica por excelencia.
bombátido	Versión electrónica 23.4 del «Diccionario de la lengua española», obra lexicográfica académica por excelencia.
elefante	1. m. y f. Mamífero del orden de los proboscidios, el mayor de los animales terrestres, con cabeza y ojos pequeños, orejas grandes y colgantes, nariz y labio superior unidos y muy prolongados en forma de trompa prensil, y dos dientes incisivos, macizos y muy grandes, vulgarmente llamados colmillos, que vive en Asia y África. U. en m. ref. a la especie.
proboscidios	 Que tiene trompa prensil formada por la soldadura de la nariz con el labio superior, y cinco dedos en las extremidades, terminado cada uno de ellos en una pequeña pezuña y englobados en una masa carnosa; p. ej., el elefante. U. t. c. s. m., en pl. como taxón.
prensil	 1. adj. Que sirve para asir o coger. Cola, trompa prensil.
trompa	1. f. Instrumento musical de viento, consistente en un tubo de latón enroscado circularmente que va ensanchándose desde la boquilla al pabellón, cuyo sonido se modifica por medio de pistones y antiguamente introduciendo la mano en el pabellón.
úrsido	 Del grupo de los carnívoros plantígrados, de gran tamaño y pelaje espeso, cuerpo robusto, cabeza ancha, ojos pequeños y extremidades fuertes con cinco dedos de uñas no retráctiles; p. ej., el oso pardo o el oso polar. U. t. c. s. m., en pl. como taxón.
marsupial	 Que tiene crías que nacen en estado de gestación poco avanzada y son incubadas generalmente en la bolsa ventral de la hembra, donde están las mamas; p. ej., el canguro de Australia o la zarigüeya de América. U. t. c. s. m., en pl. como taxón.
zarigüeya	 1. f. Mamífero marsupial americano, trepador, de aspecto parecido a la rata, de hocico alargado, pelaje gris y cola prensil.
AMPO	 1. m. Blancura resplandeciente. 2. m. Copo de nieve. U. m. en pl.
Caputbovense	Versión electrónica 23.4 del «Diccionario de la lengua española», obra lexicográfica académica por excelencia.
Chionofobia	Versión electrónica 23.4 del «Diccionario de la lengua española», obra lexicográfica académica por excelencia.
EPÓNIMOS	 Que tiene un nombre con el que se pasa a denominar una ciudad, una enfermedad, un concepto, etc. U. m. c. s. m. El doctor Alois Alzheimer es el epónimo de la enfermedad que lleva su apellido.
Ermita	 1. f. Capilla o santuario, generalmente pequeños, situados por lo común en despoblado y que no suelen tener culto permanente.
Estentóreo	 Muy fuerte, ruidoso o retumbante.
Pulpejo	1. m. Parte carnosa y mollar de un miembro pequeño del cuerpo humano, y, más comúnmente, parte de la palma de la mano de la que sale el dedo pulgar.
Terebeco	 Que tiene temblor en alguna parte del cuerpo por frío o por miedo.
Titiritear	 Dominar y controlar la forma de actuar de otra. 2. intr. El Salv. Tiritar de frío.
Trisca	 1. f. Ruido que se hace con los pies en una cosa que se quebranta. 2. f. Bulla, algazara o estruendo.
VEXILOLOGÍA	 1. f. Disciplina que estudia las banderas, pendones y estandartes.
Verdín	1. m. Color verde de la hierba o de las plantas, especialmente cuando están recién brotadas. 2. m. Capa verde de plantas como hongos, líquenes o musgos, que se forma en algunas aguas, especialmente en las estancadas, y en lugares húmedos.
abadesa	 V. abad.
amblan	 Andar moviendo a un tiempo el pie y la mano de un mismo lado. 2. intr. desus. Mover lúbricamente el cuerpo.
analepsis	 1. f. Ret. Pasaje de una obra literaria que trae una escena del pasado rompiendo la secuencia cronológica.
castañeta	1. f. castañuela (‖ instrumento musical). 2. f. Sonido que resulta de juntar la yema del dedo de en medio con la del pulgar, y hacerla resbalar con fuerza y rapidez para que choque en el pulpejo.
contrapariente	 1. adj. Pariente de parientes. U. m. c. s.
delicuescente	 Que tiene la propiedad de absorber la humedad del aire hasta formar una disolución acuosa.
dígrafo	 1. m. Ling. Secuencia de dos letras que representa un solo sonido; p. ej., en español ll, en francés ou, en catalán ny.
gacheta	1. f. engrudo. 1. f. Palanca pequeña que, oprimida por un resorte, sujeta en su posición el pestillo de algunas cerraduras, encajándose en él por medio de dientes y muescas.
gafada	Entradas que contienen la forma «gafada» | Diccionario de la lengua española | RAE - ASALE
gallicinio	Versión electrónica 23.4 del «Diccionario de la lengua española», obra lexicográfica académica por excelencia.
ginefobia	 1. f. Fobia a las mujeres.
insertos	1. adj. Que está insertado. 2. m. Cinem. Rótulo entre dos encuadres o superpuesto a uno, que, en forma legible, explica al espectador la localización o cualquier otro detalle de la escena, página de un periódico, una carta, etc.
josa	 1. f. Heredad plantada de vides y árboles frutales.
majunche	 1. adj. coloq. Ven. De calidad inferior, deslucido, mediocre.
miranda	 1. f. Paraje alto desde el cual se descubre gran extensión de terreno. de miranda 1. loc. adv. coloq. Sin hacer nada debiendo trabajar.
pangrama	Versión electrónica 23.4 del «Diccionario de la lengua española», obra lexicográfica académica por excelencia.
pichirre	 1. adj. coloq. Ven. tacaño (‖ que escatima en el gasto).
purrela	 1. f. Vino último e inferior de los que se llaman aguapié. 2. f. coloq. Cosa despreciable, de mala calidad, de poco valor.
singulto	 1. m. sollozo. 2. m. Med. hipo (‖ movimiento convulsivo).
tontolaba	Versión electrónica 23.4 del «Diccionario de la lengua española», obra lexicográfica académica por excelencia.
undívago	 1. adj. poét. Que ondea o se mueve como las olas.
valetudinarios	 Enfermizo, delicado, de salud quebrada. U. t. c. s.
aguapié	 1. m. Vino de baja calidad que se elaboraba echando agua en el orujo pisado y apurado en el lagar. 2. m. agua de pie.
capirote	 Que tiene la cabeza de distinto color que el cuerpo. 2. m. Cucurucho de cartón cubierto de tela que usan los penitentes en las procesiones de Semana Santa.
ojo	1. m. Órgano de la vista en el ser humano y en los animales. 2. m. Parte visible del ojo en la cara. 3. m. Agujero que tiene la aguja para que entre el hilo.
palabra	1. f. Unidad lingüística, dotada generalmente de significado, que se separa de las demás mediante pausas potenciales en la pronunciación y blancos en la escritura.
cucurucho	1. m. Papel, cartón, barquillo, etc., arrollado en forma cónica, empleado para contener dulces, confites, helados, cosas menudas, etc. U. t. en sent. fig.
gripa	 1. f. Col. y Méx. gripe.
gripe	 1. f. Enfermedad epidémica aguda, acompañada de fiebre y con manifestaciones variadas, especialmente catarrales.
percebes	1. m. Crustáceo cirrópodo, que tiene un caparazón compuesto de cinco piezas y un pedúnculo carnoso con el cual se adhiere a los peñascos de las costas. Se cría formando grupos y es comestible.
cirrópodo	 Que tiene el cuerpo rodeado de un caparazón compuesto de varias placas calcáreas, entre las cuales puede sacar los cirros, es hermafrodita, y libre y nadador mientras es larva, pero en estado adulto vive fijo sobre los objetos sumergidos, por lo común mediante un pedúnculo, siendo parásito en algunas especies; p. ej., el percebe o la bellota de mar. U. t. c. s. m., en pl. como taxón.
pedúnculo	1. m. Bot. Pezón de la hoja, flor o fruto. 2. m. Zool. Prolongación del cuerpo, mediante la cual están fijos al suelo algunos animales de vida sedentaria, como los percebes.
chirriar	 Hacer un ruido agudo, continuado y desagradable, generalmente al rozar con otra cosa. La puerta, los frenos chirrían.
perro	1. m. y f. Mamífero doméstico de la familia de los cánidos, de tamaño, forma y pelaje muy diversos, según las razas, que tiene olfato muy fino y es inteligente y muy leal a su dueño. U. en m. ref. a la especie.
lardo	 1. m. Parte gorda del tocino. 2. m. Grasa o unto de los animales.
pringar	1. tr. Empapar con pringue el pan u otro alimento. 2. tr. Estrujar con pan algún alimento pringoso. 3. tr. Echar a alguien pringue hirviendo, castigo usado antiguamente.
unto	1. m. Materia pingüe a propósito para untar. 2. m. Crasitud o gordura interior del cuerpo del animal. 3. m. Aquello que sirve para untar. U. m. en sent. fig.
pingüe	 1. adj. Craso, gordo, mantecoso. 2. adj. Abundante, copioso, fértil.
Crasitud	 1. f. gordura (‖ tejido adiposo).
craso	 1. adj. indisculpable. Craso error. Ignorancia crasa. 2. adj. Graso, untuoso. 3. adj. p. us. Grueso, gordo. 4. m. crasitud. brea crasa
brea	1. f. Sustancia viscosa de color rojo oscuro que se obtiene haciendo destilar al fuego la madera de varios árboles de la clase de las coníferas, y que se emplea en medicina como pectoral y antiséptico.
antiséptico	 1. adj. Med. Que sirve para la antisepsia. Apl. a un medicamento o a una sustancia, u. t. c. s. m.
tacaño	1. adj. Que escatima excesivamente en el gasto. Apl. a pers., u. t. c. s. 2. adj. desus. Astuto, pícaro, bellaco, y que engaña con sus ardides y embustes. Era u. t. c. s.
payaso	 Ambulante y que debuta en las mojigangas enmascarado.
mojigangas	1. f. Obra teatral muy breve, de carácter cómico, en la que participan figuras ridículas y extravagantes, y que antiguamente se representaba en los entreactos o al finalizar el tercer acto de las comedias.
vino	1. m. Bebida alcohólica que se hace del zumo de las uvas exprimido y fermentado naturalmente. 2. m. Zumo fermentado de plantas o frutos distintos de la uva. Vino de arroz, vino de palma.
adventicio	 Que se desarrolla en lugar distinto del habitual.
cepo	1. m. Instrumento hecho de dos maderos gruesos, que unidos forman en el medio unos agujeros redondos, en los cuales se aseguraba la garganta o la pierna del reo, juntando los maderos.
capicúa	1. m. Número que es igual leído de izquierda a derecha que de derecha a izquierda; p. ej., el 1331. U. t. c. adj. 2. m. Billete, boleto, etc., cuyo número es capicúa. U. t. c. adj.
torticero	 1. adj. Injusto, o que no se arregla a las leyes o a la razón. enriquecimiento torticero
bibliomanía	 1. f. Propensión exagerada a acumular libros.
bebé	 1. m. Niño o niña recién nacido o de muy corta edad.
fraude	1. m. Acción contraria a la verdad y a la rectitud, que perjudica a la persona contra quien se comete. 2. m. Acto tendente a eludir una disposición legal en perjuicio del Estado o de terceros.
ya	1. adv. En tiempo u ocasión pasados. Ya hemos hablado de esto más de una vez. 2. adv. Inmediatamente, ahora mismo. U. t. en sent. enfático. Aumento de salarios, ya.
madrastra	1. f. Mujer del padre de una persona nacida de una unión anterior de este. 2. f. Madre que trata mal a sus hijos. U. t. en sent. fig. La naturaleza es madrastra de los hombres.
vilo	 en vilo 1. loc. adv. Sin el apoyo físico necesario o sin estabilidad. 2. loc. adv. Con indecisión, inquietud y zozobra.
zozobra	1. f. Acción y efecto de zozobrar. 2. f. Inquietud, aflicción y congoja del ánimo, que no deja sosegar, o por el riesgo que amenaza, o por el mal que ya se padece.
anteo	Versión electrónica 23.4 del «Diccionario de la lengua española», obra lexicográfica académica por excelencia.
metáfora	1. f. Ret. Traslación del sentido recto de una voz a otro figurado, en virtud de una comparación tácita, como en las perlas del rocío, la primavera de la vida o refrenar las pasiones.
tácita	 Que no se expresa, pero se sobrentiende. La oración Estudias en la biblioteca tiene sujeto tácito.
perfil	1. m. Postura en que no se deja ver sino una sola de las dos mitades laterales del cuerpo. 2. m. Contorno de la figura de algo o de alguien.
testaferro	 1. m. y f. Persona que presta su nombre en un contrato, pretensión o negocio que en realidad es de otra persona.
inédito	 Que aún no ha publicado nada. 3. adj. Desconocido, nuevo.
nada	1. f. Inexistencia total o carencia absoluta de todo ser. Existen muchas interpretaciones de la nada entre los filósofos. Era u. menos c. m.
REBAÑAR	 1. tr. Juntar y recoger algo sin dejar nada. 2. tr. Recoger de un plato o vasija, para comerlos, los residuos de algo hasta apurarlo.
pisagua	Versión electrónica 23.4 del «Diccionario de la lengua española», obra lexicográfica académica por excelencia.
piragua	1. f. Embarcación larga y estrecha, mayor que la canoa, hecha generalmente de una pieza o con bordas de tabla o cañas. Navega a remo y vela, y la usan los indios de América y Oceanía.
pebetero	1. m. Recipiente para quemar perfumes y especialmente el que tiene cubierta agujereada. 2. m. Recipiente en el que arde una llama ceremonial.
balacado	Versión electrónica 23.4 del «Diccionario de la lengua española», obra lexicográfica académica por excelencia.
bacalao	1. m. Pez teleósteo, anacanto, de cuerpo simétrico, con tres aletas dorsales y dos anales, y una barbilla en la sínfisis de la mandíbula inferior.
anacanto	 Del grupo de los teleósteos con aletas de radios blandos y flexibles y de las cuales las abdominales están situadas debajo de las pectorales o delante de ellas; p. ej., la merluza, el bacalao o el lenguado. U. t. c. s. m., y era u. en pl. como taxón.
mariachi	1. m. Música y baile populares mexicanos procedentes del estado de Jalisco. 2. m. Orquesta popular mexicana que interpreta mariachis. 3. m. Cada uno de los componentes de un mariachi.
zotaco	Versión electrónica 23.4 del «Diccionario de la lengua española», obra lexicográfica académica por excelencia.
sotaco	Versión electrónica 23.4 del «Diccionario de la lengua española», obra lexicográfica académica por excelencia.
padecer	1. tr. Sentir física y corporalmente un daño, dolor, enfermedad, pena o castigo. U. t. c. intr. 2. tr. Soportar agravios, injurias, pesares, etc. U. t. c. intr.
radio	1. m. Geom. Segmento lineal que une un punto cualquiera de la circunferencia o de la superficie de una esfera con su centro. 2. m. Rayo de la rueda.
rueda	1. f. Pieza mecánica en forma de disco que gira alrededor de un eje. 2. f. Círculo o corro de personas o cosas. 3. f. signo rodado. 4. f. pez luna.
gato	1. m. y f. Mamífero carnívoro de la familia de los félidos, digitígrado, doméstico, de unos 50 cm de largo desde la cabeza hasta el arranque de la cola, que por sí sola mide unos 20 cm, de cabeza redonda, lengua muy áspera, patas cortas y pelaje espeso, suave, de color blanco, gris, pardo, rojizo o negro, que se empleaba en algunos lugares para cazar ratones. U. en m. ref. a la especie.
capilla	1. f. Edificio contiguo a una iglesia o parte integrante de ella, con altar y advocación particular. 2. f. Oratorio privado. 3. f. Oratorio portátil de los regimientos y otros cuerpos militares.
mucho	1. adj. indef. Numeroso, abundante o intenso. Muchos niños. Su mucho dinero. Mucha alegría. 2. adj. indef. Que excede a lo ordinario, regular o preciso. U. a menudo con un complemento introducido por la preposición para que expresa una base de comparación. Mucho trabajo para tan poco tiempo.
genio	1. m. Índole o condición según la cual obra alguien comúnmente. Es de genio apacible. 2. m. Disposición ocasional del ánimo por la cual este se manifiesta alegre, áspero o desabrido.
capa	1. f. Prenda de vestir larga y suelta, sin mangas, abierta por delante, que se lleva sobre los hombros encima del vestido. 2. f. Aquello que cubre o baña alguna cosa. Una capa de nieve, de pintura, de azúcar.
INMAMABLE	Versión electrónica 23.4 del «Diccionario de la lengua española», obra lexicográfica académica por excelencia.
erre	1. f. Letra r o dígrafo rr, y sonidos que representan. erre doble, o doble erre 1. f. Dígrafo rr. erre que erre  1. loc. adv. coloq. Porfiadamente, tercamente. estar erre alguien 1. loc. verb. desus. Mantenerse firme en un propósito.
Dígrafo	 1. m. Ling. Secuencia de dos letras que representa un solo sonido; p. ej., en español ll, en francés ou, en catalán ny.
cristo	1. m. En la doctrina cristiana, el Hijo de Dios, hecho hombre. Jesús, el Cristo. 2. m. Imagen o representación del Cristo. 3. m. crucifijo.
crucifijo	 1. m. Efigie o imagen de Cristo crucificado.
efigie	 1. f. Imagen o representación de una persona. 2. f. p. us. Personificación, representación viva de un sentimiento. La efigie del dolor.
ecúmene	 1. f. Comunidad humana que habita una porción extensa de la Tierra.
Autoantónimo	Versión electrónica 23.4 del «Diccionario de la lengua española», obra lexicográfica académica por excelencia.
antónimo	 Que, respecto de otra, expresa una idea opuesta o contraria, como virtud y vicio, claro y oscuro o antes y después. U. t. c. s. m.
vicio	1. m. Mala calidad, defecto o daño físico en las cosas. 2. m. Falta de rectitud o defecto moral en las acciones. 3. m. Falsedad, yerro o engaño en lo que se escribe o se propone. Vicios de obrepción y subrepción.
yerro	1. m. Falta o delito cometido, por ignorancia o malicia, contra los preceptos y reglas de un arte, y absolutamente, contra las leyes divinas y humanas.
calderón	1. m. Cetáceo de hasta cinco metros de longitud, de cabeza voluminosa, casi globosa, y de aletas pectorales estrechas y largas. Es de color blanquecino por debajo y negro por encima, suele ir en bandadas y se alimenta principalmente de calamares.
can	1. m. perro (‖ mamífero). 2. m. Pieza pequeña de bronce en la artillería antigua. 3. m. gatillo (‖ pieza de las armas de fuego). 4. m. Arq. Cabeza de una viga del techo interior, que carga en el muro y sobresale al exterior, sosteniendo la corona de la cornisa.
pulquérrimo	 1. adj. sup. de pulcro.
hipérbaton	 1. m. Ret. Alteración del orden que las palabras tienen habitualmente en el discurso, como en por mi mano plantado tengo un huerto.
anarquía	1. f. Ausencia de poder público. 2. f. Desconcierto, incoherencia, barullo. 3. f. anarquismo (‖ doctrina que propugna la supresión del Estado).
foral	 Que se rige por un derecho histórico mantenido por la Constitución y las leyes. Decreto foral. Diputación foral.
trashumante	 Que trashuma. 2. adj. Perteneciente o relativo a la trashumancia.
trashumancia	 1. f. Acción y efecto de trashumar.
trashumar	 Cambiar periódicamente de lugar.
perenne	 1. adj. Continuo, incesante, que no tiene intermisión. 2. adj. Bot. Que vive más de dos años.
intermisión	 1. f. Interrupción o cesación de una labor o de cualquier otra cosa por algún tiempo.
crisopeya	 1. f. Arte con que se pretendía transmutar los metales en oro.
transmutar	 1. tr. Mudar o convertir algo en otra cosa. U. t. c. prnl.
pronominal	 Que tiene por núcleo un pronombre. Sintagma pronominal.
pronombre	1. m. Gram. Clase de palabras cuyos elementos hacen las veces del sustantivo o del sintagma nominal y que se emplean para referirse a las personas, los animales o las cosas sin nombrarlos. Ella, esto, quién son pronombres.
sintagma	1. m. Gram. Palabra o conjunto de palabras que se articula en torno a un núcleo y que puede ejercer alguna función sintáctica. sintagma adjetival, o sintagma adjetivo
sánscrito	1. adj. Perteneciente o relativo al sánscrito. Léxico sánscrito. 2. m. Lengua del grupo indio, derivada del védico, que se habló en el norte de la India desde fecha antigua hasta el siglo III a. C. y que después continuó existiendo como lengua escrita de las religiones, la literatura y el pensamiento.
moni	 1. m. coloq. moneda (‖ dinero). U. m. en pl.
monis	 V. moni.
verborragia	 1. f. Verbosidad excesiva.
verbosidad	 1. f. Abundancia de palabras en la elocución.
Mamífero	 Del grupo de los vertebrados de temperatura constante cuyo embrión, provisto de amnios y alantoides, se desarrolla casi siempre dentro del seno materno, y cuyas crías son alimentadas por las hembras con la leche de sus mamas. U. t. c. s. m., en pl. como taxón.
amnios	1. m. Zool. Saco cerrado que envuelve y protege el embrión de los reptiles, aves y mamíferos, y que se forma como membrana extraembrionaria, llena de líquido amniótico.
eteria	Versión electrónica 23.4 del «Diccionario de la lengua española», obra lexicográfica académica por excelencia.
peregrinación	 1. f. Acción y efecto de peregrinar.
peregrinar	 Andar por tierras extrañas. 2. intr. Ir en romería a un santuario por devoción o por voto. 3. intr. coloq. Andar de un lugar a otro buscando o resolviendo algo.
romería	1. f. Viaje o peregrinación, especialmente la que se hace por devoción a un santuario. 2. f. Fiesta popular que con meriendas, bailes, etc., se celebra en el campo inmediato a alguna ermita o santuario el día de la festividad religiosa del lugar.
HELIOCENTRISMO	1. m. Teoría astronómica difundida a mediados del siglo XVI por el astrónomo polaco Copérnico, que consideraba el Sol como centro del universo.
sibilino	 1. adj. Perteneciente o relativo a la sibila. 2. adj. Misterioso u oscuro, a veces con apariencia de importante.
sibila	 1. f. Mujer sabia a quien los antiguos atribuyeron espíritu profético.
monasterio	 1. m. Casa o convento, ordinariamente fuera de poblado, donde viven en comunidad los monjes. 2. m. Casa de religiosos.
monje	1. m. y f. Persona que pertenece a una orden religiosa y vive en un monasterio. 2. m. anacoreta. 3. m. paro carbonero. 4. f. Religiosa de una orden o congregación.
anacoreta	 1. m. y f. Persona que vive en lugar solitario, entregada enteramente a la contemplación y a la penitencia.
carbonero	1. adj. Perteneciente o relativo al carbón. 2. m. y f. Persona que fabrica o vende carbón. 3. m. Cuba y P. Rico. Nombre genérico común a varias plantas de diferentes familias, como las mimosáceas o las euforbiáceas, cuya madera se utiliza para hacer carbón.
llantén	1. m. Planta herbácea, vivaz, de la familia de las plantagináceas, con hojas radicales, pecioladas, gruesas, anchas, ovaladas, enteras o algo ondeadas por el margen, flores sobre un escapo de 20 a 30 cm de altura, en espiga larga y apretada, pequeñas, verdosas, de corola tubular en la base y partida en cuatro pétalos en cruz, fruto capsular con dos divisiones, y semillas pardas elipsoidales, que es muy común en los sitios húmedos, y el cocimiento de sus hojas se usa en medicina.
antinomia	 1. f. Contradicción entre dos preceptos legales. 2. f. Contradicción entre dos principios racionales.
vorágine	1. f. Remolino impetuoso que hacen en algunos parajes las aguas del mar, de los ríos o de los lagos. 2. f. Pasión desenfrenada o mezcla de sentimientos muy intensos.
pigricia	 1. f. Pereza, ociosidad, negligencia, descuido. 2. f. Bol. pizca.
vespertilio	 1. m. p. us. murciélago.
desinencia	 1. f. Gram. Morfema flexivo pospuesto a la raíz, especialmente la de un verbo.
morfema	 mujer y -es. 2. m. Gram. Por oposición a lexema, morfema gramatical; p. ej., de, no, yo, el, -ar, -s, -ero.
lexema	1. m. Ling. Unidad mínima con significado léxico que no presenta morfemas gramaticales; p. ej., sol, o que, poseyéndolos, prescinde de ellos por un proceso de segmentación; p. ej., terr, en enterráis.
altísimo	 el Altísimo 1. m. Dios.
parietal	 1. adj. Perteneciente o relativo a la pared. 2. m. Anat. hueso parietal.
mano	1. f. Parte del cuerpo humano unida a la extremidad del antebrazo y que comprende desde la muñeca inclusive hasta la punta de los dedos. 2. f. En algunos animales, extremidad cuyo dedo pulgar puede oponerse a los otros.
picar	1. tr. Pinchar una superficie con un instrumento punzante. U. t. c. prnl. 2. tr. Cortar o dividir en trozos muy menudos. 3. tr. Golpear con pico, piqueta u otro instrumento adecuado, la superficie de las piedras para labrarlas, o la de las paredes para revocarlas.
víspera	1. f. Día que antecede inmediatamente a otro determinado, especialmente si es fiesta. 2. f. Cosa que antecede a otra, y en cierto modo la ocasiona.
pinito	1. m. Cada uno de los primeros pasos que da el niño o el convaleciente. U. m. en pl. Está haciendo pinitos. 2. m. pl. Primeros pasos que se dan en algún arte o ciencia.
barroco	 Que se desarrolló en Europa e Iberoamérica durante los siglos XVII y XVIII, opuesto al clasicismo y caracterizado por la complejidad y el dinamismo de las formas, la riqueza de la ornamentación y el efectismo. U. t. c. s. m.
ANFIBOLOGÍA	1. f. Doble sentido, vicio de la palabra, cláusula o manera de hablar a que puede darse más de una interpretación. 2. f. Ret. Empleo voluntario de voces o cláusulas con doble sentido.
Ampo	 1. m. Blancura resplandeciente. 2. m. Copo de nieve. U. m. en pl.
CARCA	Entradas que contienen la forma «CARCA» | Diccionario de la lengua española | RAE - ASALE
CORCOVA	1. f. Corvadura anómala de la columna vertebral, o del pecho, o de ambos a la vez. 2. f. desus. Corvadura de cualquier cosa, o bulto que altera su forma normal exterior.
Carolingio	1. adj. Integrante de la dinastía fundada por el emperador Carlomagno en los siglos VIII y IX. U. t. c. s. 2. adj. Perteneciente o relativo a Carlomagno, a su dinastía o a su época.
Carámbanos	1. m. Pedazo de hielo más o menos largo y puntiagudo. 2. m. Nic. carao. estar hecho, cha un carámbano 1. loc. verb. coloq. Tener mucho frío.
Catégra	Versión electrónica 23.4 del «Diccionario de la lengua española», obra lexicográfica académica por excelencia.
Cello	 1. m. Aro con que se sujetan las duelas de las cubas, comportas, pipotes, etc.
Cerdudo	 Que tiene mucho pelo y fuerte en el pecho. 3. m. desus. cerdo (‖ mamífero).
Chuchurrio	Versión electrónica 23.4 del «Diccionario de la lengua española», obra lexicográfica académica por excelencia.
Epílogo	1. m. Recapitulación de lo dicho en un discurso o en otra composición literaria. 2. m. Última parte de una obra, en la que se refieren hechos posteriores a los recogidos en ella o reflexiones relacionadas con su tema central.
Forado	1. adj. desus. Que está horadado. 2. m. Bol., Chile, Ec., Perú y Ven. Horado hecho en una pared. 3. m. desus. Abertura más o menos redonda.
Fragor	 1. m. Ruido estruendoso.
LAMPION	Versión electrónica 23.4 del «Diccionario de la lengua española», obra lexicográfica académica por excelencia.
Onomateca	Versión electrónica 23.4 del «Diccionario de la lengua española», obra lexicográfica académica por excelencia.
Picar	1. tr. Pinchar una superficie con un instrumento punzante. U. t. c. prnl. 2. tr. Cortar o dividir en trozos muy menudos. 3. tr. Golpear con pico, piqueta u otro instrumento adecuado, la superficie de las piedras para labrarlas, o la de las paredes para revocarlas.
Pitiyanqui	 1. m. despect. Ven. Imitador del estadounidense.
SOLECISMO	 1. m. Gram. Falta de sintaxis; error cometido contra las normas de algún idioma.
Toponimia	1. f. Conjunto de los nombres propios de lugar de un país o de una región. 2. f. Ling. Rama de la onomástica que estudia el origen de los nombres propios de lugar, así como el significado de sus étimos.
abuelazón	 1. f. Pan. Condición anímica de los abuelos que muestran de forma exagerada cariño por su nieto.
acepciones	1. f. Cada uno de los significados de una palabra según los contextos en que aparece. 2. f. desus. aceptación (‖ aprobación). acepción de personas
aherrojar	 1. tr. Poner a alguien prisiones de hierro. 2. tr. Oprimir, subyugar.
ahonda	1. tr. Hacer algo hondo o más hondo de lo que era. Ahondar un pozo. U. t. en sent. fig. Ahondar una rivalidad. U. t. c. prnl. 2. tr. Cavar profundizando.
ajorca	 1. f. Especie de argolla de oro, plata u otro metal, usada para adornar las muñecas, brazos o tobillos.
alatés	 1. m. germ. Criado o mozo de un rufián o ladrón.
albugíneo	 Que rodea el tejido propio del testículo y es fibrosa, blanca y brillante. U. t. c. s. f.
allende	1. prep. cult. Más allá de. Su fama se extendía allende nuestras fronteras. Se dirigió hacia allende las dunas. 2. prep. cult. Además de, fuera de. Tomaron el vino que habían traído, allende lo que había en la bodega.
anosmia	 1. f. Pérdida completa del olfato.
arrostrar	1. tr. Hacer cara, resistir, sin dar muestras de cobardía, a las calamidades o peligros. 2. tr. Sufrir o tolerar a alguien o algo desagradable. U. t. c. intr.
atezado	 Bronceado o moreno. 2. adj. De color atezado.
bagrero	 Que gusta de las mujeres muy feas. U. t. c. s. m.
barbullido	 1. m. Rizado que produce en la superficie de la mar el paso de un banco de sardinas.
bisoño	 nuevo (‖ principiante). U. t. c. s. 2. adj. coloq. Nuevo e inexperto en cualquier arte u oficio. U. t. c. s.
botafumeiro	 1. m. incensario. 2. m. coloq. adulación. manejar el botafumeiro 1. loc. verb. coloq. adular.
brasil	1. m. Árbol de la familia de las papilionáceas, que crece en los países tropicales, y cuya madera es el palo brasil. 2. m. palo brasil (‖ madera).
cacosmia	 1. f. Med. Olor fétido. 2. f. Med. Alteración del sentido del olfato, que causa una percepción anormal de los olores.
calambur	1. m. Ret. Agrupación de varias sílabas de modo que alteren el significado de las palabras a que pertenecen, como en este es conde y disimula.
capicúa	1. m. Número que es igual leído de izquierda a derecha que de derecha a izquierda; p. ej., el 1331. U. t. c. adj. 2. m. Billete, boleto, etc., cuyo número es capicúa. U. t. c. adj.
carcamal	 1. m. despect. coloq. Persona decrépita y achacosa. U. t. c. adj.
catire	 Rubia, en especial con el pelo rojizo y ojos verdosos o amarillentos, por lo común hija de blanco y mulata, o viceversa.
ceromancia	1. f. p. us. Adivinación que consiste en ir echando gotas de cera derretida en una vasija llena de agua, para hacer cómputos o deducciones según las figuras que se forman.
chollo	 1. m. coloq. Cosa valiosa o apreciable que se adquiere a muy bajo precio o con poco esfuerzo. U. t. en sent. irón.
cipayo	 1. m. Soldado indio de los siglos XVIII y XIX al servicio de Francia, Portugal y Gran Bretaña. 2. m. despect. Secuaz a sueldo.
cocobolo	1. m. Árbol de América, de la familia de las poligonáceas, que alcanza unos 30 m de altura, con tronco grueso y derecho, hojas muy grandes, casi redondas, rugosas y de color verde rojizo, flores encarnadas en racimos, y frutos parecidos a la guinda.
cuesco	1. m. Hueso de la fruta; p. ej., el de la guinda, el durazno, etc. 2. m. En los molinos de aceite, piedra redonda en que la viga aprieta los capachos.
deicidio	 1. m. Acción de dar muerte a Dios, referido especialmente a la de Jesucristo.
desbravar	 Romperse, desahogarse su ímpetu. U. t. c. prnl.
desgorre	 1. m. coloq. Hond. Participación en juergas o fiestas en las que se producen alborotos, escándalo y algún tipo de relación amorosa.
desternillante	 1. adj. Cómico, hilarante.
epéntesis	 1. f. Fon. Adición de algún sonido en una palabra, especialmente en posición interior, como en tendré, del antiguo tenré.
eviternas	 1. adj. cult. Que, habiendo comenzado en el tiempo, no tendrá fin.
fardos	1. m. Lío grande de ropa u otra cosa, muy apretado, para poder llevarlo de una parte a otra. Se hace regularmente con las mercancías que se han de transportar, cubriéndolas con arpillera o lienzo embreado o encerado, para que no se maltraten.
fetén	1. adj. Bueno, estupendo, excelente. Conocí a una chica fetén. 2. adj. coloq. Sincero, auténtico, verdadero, evidente. 3. f. coloq. La verdad. La fetén.
filicidio	 1. m. Muerte dada por un padre o una madre a su propio hijo.
flabelífero	1. m. y f. Persona que tenía por oficio llevar y agitar un abanico grande montado en una vara, en ciertas ceremonias religiosas o cortesanas.
follón	1. adj. p. us. Flojo, perezoso y negligente. U. t. c. s. 2. adj. p. us. Vano, arrogante, cobarde y de ruin proceder. U. t. c. s. 3. m. Cohete que se dispara sin trueno.
frufrú	 1. onomat. U. para imitar el ruido que produce el roce de la seda o de otra tela semejante. U. t. c. s. m.
gargamillón	 1. m. germ. Cuerpo humano.
glugutear	Versión electrónica 23.4 del «Diccionario de la lengua española», obra lexicográfica académica por excelencia.
hipocorísticos	 Que, en forma diminutiva, abreviada o infantil, se usa como designación cariñosa, familiar o eufemística; p. ej., Pepe, Charo. U. t. c. s. m.
hortatorio	 1. adj. desus. exhortatorio.
intonso	 Que se encuaderna sin cortar los pliegos de que se compone.
jofaina	 1. f. Vasija en forma de taza, de gran diámetro y poca profundidad, que sirve principalmente para lavarse la cara y las manos.
latiniparla	 1. f. Lenguaje de quienes emplean con afectación voces latinas al hablar o escribir en español o en otro idioma que no sea el latino.
malacia	1. f. Med. Perversión del apetito que consiste en el deseo de comer materias extrañas e impropias para la nutrición, como yeso, carbón, cal, arena, tierra u otras cosas.
mangonero	 Que tiene muchas fiestas y en que apenas se trabaja.
marchamador	 1. m. y f. Persona que tiene el oficio de marchamar.
marramao	 1. onomat. U. para imitar el maullido del gato en la época del celo. U. t. c. s. m. El marramao del gato.
merino	 Que tiene el hocico grueso y ancho, la nariz con arrugas transversas, y la cabeza y las extremidades cubiertas, como todo el cuerpo, de lana muy fina, corta y rizada. U. t. c. s.
morcillona	 En estado anterior a su plena erección.
nigromancia	 1. f. Adivinación mediante la invocación a los muertos. 2. f. coloq. Magia negra o diabólica.
oblito	 1. m. Med. Cuerpo extraño olvidado en el interior de un paciente durante una intervención quirúrgica.
oniromancia	 1. f. Adivinación por medio de los sueños.
onocrótalo	 1. m. pelícano (‖ ave).
onomancia	 1. f. Adivinación de lo concerniente a una persona por su nombre.
oreo	 1. m. Soplo del aire que da suavemente en algo. 2. m. Acción y efecto de orear u orearse.
pajla	 Calva, sin pelo. U. t. c. s.
palitroque	1. m. Palo pequeño, tosco o mal labrado. 2. m. Taurom. banderilla (‖ palo para clavar en los toros). 3. m. Cuba. colín (‖ barra de pan pequeña).
palíndromo	1. m. Palabra o frase cuyas letras están dispuestas de tal manera que resulta la misma leída de izquierda a derecha que de derecha a izquierda; p. ej., anilina; dábale arroz a la zorra el abad.
pelamesa	 1. f. Riña o pelea en que los contendientes se asen y mesan los cabellos o la barba. 2. f. Porción de pelo que se puede asir o mesar.
peoresnadino	Versión electrónica 23.4 del «Diccionario de la lengua española», obra lexicográfica académica por excelencia.
perentoria	 1. adj. Concluyente o definitivo. 2. adj. Urgente, apremiante. excepción perentoria término perentorio
pigricia	 1. f. Pereza, ociosidad, negligencia, descuido. 2. f. Bol. pizca.
pijo	 Que en su vestuario, modales, lenguaje, etc., manifiesta afectadamente gustos propios de una clase social adinerada. U. t. c. s.
pólice	 1. m. Dedo pulgar.
rataplán	1. onomat. U. para imitar el sonido del tambor. 2. m. En los diarios, resumen en primera página de una noticia que se publica en el interior.
redova	 1. f. Danza polaca, menos viva que la mazurca. 2. f. Música de la redova.
regicidio	 1. m. Muerte violenta dada al rey o a la reina.
rocambolesco	 Extraordinario, exagerado o inverosímil.
salvante	 1. prep. p. us. Fuera de, con excepción de, excepto. U. t. c. adv.
sambenito	1. m. Capotillo o escapulario que se ponía a los penitentes reconciliados por el tribunal eclesiástico de la Inquisición. 2. m. Letrero que se ponía en las iglesias con el nombre y castigo de los penitenciados, y las señales de su castigo.
secaleche	 1. m. y f. El Salv. y Hond. Último hijo de un matrimonio.
sobrancero	 Que está sin trabajar y sin oficio determinado. U. t. c. s. 2. adj. R. Dom. y Ven. Que sobra o excede en tamaño, cantidad o peso.
soportal	1. m. Espacio cubierto que en algunas casas precede a la entrada principal. 2. m. Espacio cubierto, a manera de claustro, que tienen algunos edificios o manzanas de casas en sus fachadas para protegerse de la lluvia, el frío, etc. U. m. en pl. con el mismo significado que en sing.
sápida	 Que tiene algún sabor.
taheño	 Rojo. 2. adj. Que tiene el pelo o la barba rojos.
taíno	 De un pueblo amerindio del gran grupo lingüístico arahuaco que estaba establecido en La Española y también en Cuba y Puerto Rico cuando se produjo el descubrimiento de América. U. t. c. s.
teósofo	 1. m. y f. Persona que profesa la teosofía.
traca	1. f. Artificio de pólvora que se hace con una serie de petardos colocados a lo largo de una cuerda y que estallan sucesivamente. 2. f. Gran estampido final de una traca.
trastabillar	 1. intr. Dar traspiés o tropezones. 2. intr. Tambalearse, vacilar, titubear. 3. intr. Tartalear, tartamudear, trabarse al hablar.
trifinio	 1. m. Punto donde confluyen y finalizan los términos de tres jurisdicciones o divisiones territoriales.
truchimán	1. m. y f. intérprete (‖ persona que explica lo dicho en otra lengua). 2. m. y f. Persona sagaz y astuta, poco escrupulosa en su proceder. U. t. c. adj.
tábido	 1. adj. Med. Extenuado por consunción. 2. adj. desus. Podrido o corrompido.
uxoricidio	 1. m. Muerte causada a la mujer por su marido.
vidajena	 Que fisgonea a otra. U. t. c. s.
zaratán	 1. m. Cáncer de mama en la mujer. 1. m. coloq. Seg. y Vall. Cordelería, taller u obrador donde se hacen cordeles.
zatico	 1. m. desus. Mendrugo o pedazo de pan. 2. m. desus. Hombre que antiguamente tenía en palacio el cargo de cuidar del pan y alzar las mesas.
zoizo	 1. m. Persona que formaba parte de la suiza (‖ soldadesca festiva de a pie). 2. m. Antiguo soldado de infantería.
zullenco	 1. adj. coloq. Que ventosea con frecuencia e involuntariamente o no puede contener la deposición2.
arsonista	Versión electrónica 23.4 del «Diccionario de la lengua española», obra lexicográfica académica por excelencia.
arsonismo	Versión electrónica 23.4 del «Diccionario de la lengua española», obra lexicográfica académica por excelencia.
arzón	 1. m. Parte delantera o trasera que une los dos brazos longitudinales del fuste de una silla de montar. pistola de arzón
dedo	1. m. Cada uno de los cinco apéndices articulados en que terminan la mano y el pie del hombre y, en el mismo o menor número, de muchos animales.
